STT,year,location_code,Tong_Import,Tong_Export,Balance
1,1962,AGO,120358039,132183456,11825417
2,1962,ALB,8720776,1996763,-6724013
3,1962,AND,0,59746,59746
4,1962,ANT,740418287,673955928,-66462359
5,1962,ARE,2111,2254,143
6,1962,ARG,1310910750,1413246938,102336188
7,1962,ATG,6800,0,-6800
8,1962,AUS,1741707975,1914505863,172797888
9,1962,AUT,1246727905,924054095,-322673810
10,1962,BDI,10412942,4575152,-5837790
11,1962,BEL,4413329241,4150377338,-262951903
12,1962,BEN,26226101,13126330,-13099771
13,1962,BFA,26919001,13286946,-13632055
14,1962,BGR,84223573,85552981,1329408
15,1962,BHR,61877970,142056391,80178421
16,1962,BHS,125678488,11628804,-114049684
17,1962,BLZ,95947,58701,-37246
18,1962,BMU,98444755,10247287,-88197468
19,1962,BOL,84988064,57177424,-27810640
20,1962,BRA,1345794938,1318518057,-27276881
21,1962,BRB,31132713,13010469,-18122244
22,1962,BRN,13785481,7564540,-6220941
23,1962,CAF,19126647,10515351,-8611296
24,1962,CAN,5590598638,6128864196,538265558
25,1962,CHE,3092198532,2147492138,-944706394
26,1962,CHL,519112569,604880338,85767769
27,1962,CHN,418152477,551122307,132969830
28,1962,CIV,145653348,220456347,74802999
29,1962,CMR,94383366,136320554,41937188
30,1962,COD,198631950,359365421,160733471
31,1962,COG,55340848,33521181,-21819667
32,1962,COK,49399,44460,-4939
33,1962,COL,458119977,478563422,20443445
34,1962,COM,4175170,162494,-4012676
35,1962,CPV,1190272,34535,-1155737
36,1962,CRI,98221054,78336970,-19884084
37,1962,CUB,100847210,135561825,34714615
38,1962,CYP,101042837,55183415,-45859422
39,1962,DEU,11232621512,13228314430,1995692918
40,1962,DJI,14480069,1697170,-12782899
41,1962,DMA,0,54202,54202
42,1962,DNK,2005329711,1595388076,-409941635
43,1962,DOM,129798079,184943461,55145382
44,1962,DZA,709298069,789359549,80061480
45,1962,ECU,100756676,141543861,40787185
46,1962,EGY,561679511,199159570,-362519941
47,1962,ESP,1591722613,882579333,-709143280
48,1962,ETH,98149051,78145974,-20003077
49,1962,FIN,866203272,849867120,-16336152
50,1962,FJI,19049413,13963367,-5086046
51,1962,FRA,7099360125,7029985273,-69374852
52,1962,FRO,0,12818,12818
53,1962,GAB,32581248,74356405,41775157
54,1962,GBR,10987945098,10477403658,-510541440
55,1962,GHA,290771305,278962461,-11808844
56,1962,GIB,7963967,19692,-7944275
57,1962,GIN,28066227,32801790,4735563
58,1962,GMB,8255232,9843075,1587843
59,1962,GNB,17172148,14743676,-2428472
60,1962,GNQ,7835799,1209481,-6626318
61,1962,GRC,656008652,240083180,-415925472
62,1962,GRL,1196299,0,-1196299
63,1962,GTM,115470462,125016276,9545814
64,1962,GUY,49945453,74422524,24477071
65,1962,HKG,1100569609,706877179,-393692430
66,1962,HND,63714349,56059716,-7654633
67,1962,HTI,37057395,43909554,6852159
68,1962,HUN,208423550,154915558,-53507992
69,1962,IDN,599499017,681799120,82300103
70,1962,IND,1947369177,1315686145,-631683032
71,1962,IRL,646483647,444766072,-201717575
72,1962,IRN,422445866,929343293,506897427
73,1962,IRQ,238972616,724916471,485943855
74,1962,ISL,76218171,68660273,-7557898
75,1962,ISR,527902778,254643163,-273259615
76,1962,ITA,5618170476,4282244397,-1335926079
77,1962,JAM,205081633,214133892,9052259
78,1962,JOR,79203747,4203217,-75000530
79,1962,JPN,4609332954,4487818174,-121514780
80,1962,KEN,211408612,187964405,-23444207
81,1962,KHM,81391785,56346435,-25045350
82,1962,KOR,435237099,53435054,-381802045
83,1962,KWT,216805816,1361261030,1144455214
84,1962,LAO,22139671,428374,-21711297
85,1962,LBN,257775372,87465924,-170309448
86,1962,LBR,236501312,93461864,-143039448
87,1962,LBY,212037879,143665861,-68372018
88,1962,LKA,323063090,369464696,46401606
89,1962,MAC,1552,4099557,4098005
90,1962,MAR,381072989,411968616,30895627
91,1962,MDG,98734955,94947053,-3787902
92,1962,MDV,0,2755,2755
93,1962,MEX,1108413915,930152646,-178261269
94,1962,MLI,24640587,4976591,-19663996
95,1962,MLT,96225546,8144572,-88080974
96,1962,MMR,203749777,258270454,54520677
97,1962,MNG,357102,4852433,4495331
98,1962,MOZ,94976712,80494096,-14482616
99,1962,MRT,36714646,2356055,-34358591
100,1962,MUS,33277339,39425577,6148238
101,1962,NCL,45238894,34383022,-10855872
102,1962,NER,19955894,15749233,-4206661
103,1962,NGA,486670068,489342080,2672012
104,1962,NIC,80065553,76716552,-3349001
105,1962,NLD,5587571969,4407099271,-1180472698
106,1962,NOR,1548778044,955900072,-592877972
107,1962,NPL,1176557,284144,-892413
108,1962,NZL,522896502,823457626,300561124
109,1962,OMN,22910992,4348669,-18562323
110,1962,PAK,721902979,399193278,-322709701
111,1962,PAN,233889390,70177879,-163711511
112,1962,PER,474561945,611554558,136992613
113,1962,PHL,600413447,640176321,39762874
114,1962,PNG,11563551,14757835,3194284
115,1962,POL,515275419,484297779,-30977640
116,1962,PRK,6035925,6312856,276931
117,1962,PRT,591934562,374882305,-217052257
118,1962,PRY,45506583,39262613,-6243970
119,1962,PYF,23761329,3054,-23758275
120,1962,QAT,41147827,126857652,85709825
121,1962,REU,52997476,38449429,-14548047
122,1962,ROU,237374883,182535595,-54839288
123,1962,SAU,220424778,760909548,540484770
124,1962,SDN,172080834,159336846,-12743988
125,1962,SEN,206151154,185927660,-20223494
126,1962,SGP,909988067,451489758,-458498309
127,1962,SLE,64462120,41545994,-22916126
128,1962,SLV,92093058,113895708,21802650
129,1962,SOM,29814394,18145893,-11668501
130,1962,SPM,20788,122235,101447
131,1962,STP,908250,27133,-881117
132,1962,SUR,47754823,44261124,-3493699
133,1962,SWE,2854569280,2662924526,-191644754
134,1962,SYR,159420190,165939809,6519619
135,1962,TCD,20587644,19624548,-963096
136,1962,TGO,22211849,24100177,1888328
137,1962,THA,504562889,390444537,-114118352
138,1962,TLS,20697461,51055031,30357570
139,1962,TTO,238406748,216665689,-21741059
140,1962,TUN,215173803,177345341,-37828462
141,1962,TUR,594336881,371764947,-222571934
142,1962,TWN,360707571,236967839,-123739732
143,1962,UGA,20469697,27998237,7528540
144,1962,URY,192420588,124542403,-67878185
145,1962,USA,15545429331,19535444243,3990014912
146,1962,VCT,610299,0,-610299
147,1962,VEN,885800218,2701493574,1815693356
148,1962,VIR,583534,0,-583534
149,1962,VNM,270264726,56641421,-213623305
150,1962,VUT,10649955,21622714,10972759
151,1962,WSM,689934,0,-689934
152,1962,YEM,845851,5250741,4404890
153,1962,ZAF,1152916064,1086042841,-66873223
154,1963,AGO,118722491,141299465,22576974
155,1963,ALB,8270924,3203308,-5067616
156,1963,ANT,719593009,679670555,-39922454
157,1963,ARE,745974,35957,-710017
158,1963,ARG,850909215,1495775299,644866084
159,1963,ATG,1196,0,-1196
160,1963,AUS,2206842061,2685567195,478725134
161,1963,AUT,1580125634,1188125946,-391999688
162,1963,BDI,11997749,5099680,-6898069
163,1963,BEL,5169371156,5015313790,-154057366
164,1963,BEN,36800386,15228082,-21572304
165,1963,BFA,27247571,9692274,-17555297
166,1963,BGR,129842420,122300245,-7542175
167,1963,BHR,68378964,134057778,65678814
168,1963,BHS,127410161,11450616,-115959545
169,1963,BLZ,139481,56090,-83391
170,1963,BMU,84493495,13715510,-70777985
171,1963,BOL,78413493,60453472,-17960021
172,1963,BRA,1286803897,1411162786,124358889
173,1963,BRB,36281229,38968450,2687221
174,1963,BRN,18374042,16666131,-1707911
175,1963,CAF,22120005,14929601,-7190404
176,1963,CAN,5874463885,6387252930,512789045
177,1963,CHE,3374676134,2365621091,-1009055043
178,1963,CHL,597640622,595931328,-1709294
179,1963,CHN,625517890,693252172,67734282
180,1963,CIV,181541362,267190637,85649275
181,1963,CMR,109088986,153427447,44338461
182,1963,COD,183806670,333383059,149576389
183,1963,COG,61755497,41234250,-20521247
184,1963,COK,1300,0,-1300
185,1963,COL,480445620,479536467,-909153
186,1963,COM,2005117,326510,-1678607
187,1963,CRI,104046158,82734154,-21312004
188,1963,CUB,135683595,223140374,87456779
189,1963,CYP,109121591,58177461,-50944130
190,1963,DEU,12314211522,15091432597,2777221075
191,1963,DJI,20368142,1292459,-19075683
192,1963,DMA,1500,0,-1500
193,1963,DNK,1974480153,1817371226,-157108927
194,1963,DOM,163058693,170809918,7751225
195,1963,DZA,689757491,721708038,31950547
196,1963,ECU,133036815,186036566,52999751
197,1963,EGY,658869588,239975587,-418894001
198,1963,ESH,0,9367,9367
199,1963,ESP,1927326027,930895394,-996430633
200,1963,ETH,84936254,77018499,-7917755
201,1963,FIN,939036117,1001985845,62949728
202,1963,FJI,36977771,41098103,4120332
203,1963,FRA,8285312206,7840974037,-444338169
204,1963,GAB,41247778,95295464,54047686
205,1963,GBR,12097226098,11391335102,-705890996
206,1963,GHA,306903547,262705830,-44197717
207,1963,GIB,705257,27790,-677467
208,1963,GIN,24497702,39375106,14877404
209,1963,GMB,8381704,8866198,484494
210,1963,GNB,16255283,15659001,-596282
211,1963,GNQ,6836352,3411613,-3424739
212,1963,GRC,806125966,265569784,-540556182
213,1963,GTM,156286344,166915521,10629177
214,1963,GUY,46304517,95946789,49642272
215,1963,HKG,1282712649,821007577,-461705072
216,1963,HND,87238664,72552282,-14686382
217,1963,HTI,32712348,45121545,12409197
218,1963,HUN,324616085,275572013,-49044072
219,1963,IDN,550867263,685447131,134579868
220,1963,IND,2123777491,1428471694,-695305797
221,1963,IRL,796332261,535407940,-260924321
222,1963,IRN,485364604,1228919791,743555187
223,1963,IRQ,260694873,964575607,703880734
224,1963,ISL,97086542,83011851,-14074691
225,1963,ISR,586275251,332615854,-253659397
226,1963,ITA,7096073678,4683402414,-2412671264
227,1963,JAM,203706949,254094658,50387709
228,1963,JOR,102589982,5172126,-97417856
229,1963,JPN,5737638214,5012219045,-725419169
230,1963,KEN,234932804,216677740,-18255064
231,1963,KHM,91455428,74116729,-17338699
232,1963,KOR,492409660,85025506,-407384154
233,1963,KWT,251363616,1575117259,1323753643
234,1963,LAO,28527159,636644,-27890515
235,1963,LBN,336697760,103038422,-233659338
236,1963,LBR,343350783,104471611,-238879172
237,1963,LBY,235658157,400484515,164826358
238,1963,LKA,324209123,369205141,44996018
239,1963,MAC,5000,35811,30811
240,1963,MAR,439763971,458071876,18307905
241,1963,MDG,104466859,96190073,-8276786
242,1963,MDV,622319,0,-622319
243,1963,MEX,1191955299,980703544,-211251755
244,1963,MLI,23889394,12888418,-11000976
245,1963,MLT,116493340,9704255,-106789085
246,1963,MMR,221495717,259417618,37921901
247,1963,MNG,659650,4816517,4156867
248,1963,MOZ,107461461,95313012,-12148449
249,1963,MRT,26759931,14950906,-11809025
250,1963,MUS,40554366,105079975,64525609
251,1963,NCL,52730128,45574191,-7155937
252,1963,NER,30688893,25205762,-5483131
253,1963,NGA,517847167,527720272,9873105
254,1963,NIC,90300333,98366710,8066377
255,1963,NLD,7733449392,5975222420,-1758226972
256,1963,NOR,1710916591,1063419226,-647497365
257,1963,NPL,1735973,157390,-1578583
258,1963,NZL,782243257,954517178,172273921
259,1963,OMN,36687128,34310432,-2376696
260,1963,PAK,847642069,451306940,-396335129
261,1963,PAN,292281856,99452306,-192829550
262,1963,PER,529011017,636637979,107626962
263,1963,PHL,771584807,779096800,7511993
264,1963,PNG,55481956,35644287,-19837669
265,1963,POL,628760237,589868728,-38891509
266,1963,PRK,13546523,11489136,-2057387
267,1963,PRT,666611780,423318449,-243293331
268,1963,PRY,41813081,44981045,3167964
269,1963,PYF,131220,0,-131220
270,1963,QAT,43993662,143168257,99174595
271,1963,REU,56866524,39263940,-17602584
272,1963,ROU,270264435,261182422,-9082013
273,1963,RWA,465958,150639,-315319
274,1963,SAU,237461028,905100225,667639197
275,1963,SDN,248518871,210203673,-38315198
276,1963,SEN,224275112,189021720,-35253392
277,1963,SGP,944183592,418580334,-525603258
278,1963,SLE,67532113,45825856,-21706257
279,1963,SLV,144465283,151176136,6710853
280,1963,SOM,21980346,23812363,1832017
281,1963,SPM,291126,1045,-290081
282,1963,SUR,44414512,45888702,1474190
283,1963,SWE,3126637630,3031065676,-95571954
284,1963,SYC,378305,0,-378305
285,1963,SYR,153909245,199463108,45553863
286,1963,TCD,20409538,19769100,-640438
287,1963,TGO,27240053,24304145,-2935908
288,1963,THA,552700349,397293732,-155406617
289,1963,TLS,18610020,50526398,31916378
290,1963,TTO,293119377,273812410,-19306967
291,1963,TUN,212450353,199368121,-13082232
292,1963,TUR,665319409,386443889,-278875520
293,1963,TWN,366700157,367311471,611314
294,1963,UGA,26272731,49428198,23155467
295,1963,URY,159192315,164970331,5778016
296,1963,USA,16237780614,21416963050,5179182436
297,1963,VEN,924808627,2656448961,1731640334
298,1963,VIR,5500,10206,4706
299,1963,VNM,307231683,85012483,-222219200
300,1963,VUT,26356477,33940130,7583653
301,1963,WSM,3052173,1993624,-1058549
302,1963,YEM,19275186,3461105,-15814081
303,1963,ZAF,1603644232,1200026657,-403617575
304,1964,AGO,141607342,209634170,68026828
305,1964,ALB,14631116,3867655,-10763461
306,1964,AND,0,3323,3323
307,1964,ANT,626253467,651159338,24905871
308,1964,ARE,966046,0,-966046
309,1964,ARG,1073229117,1604424994,531195877
310,1964,ATG,11595,0,-11595
311,1964,AUS,2697798849,2980977170,283178321
312,1964,AUT,1785854856,1306588832,-479266024
313,1964,BDI,13215430,29750429,16534999
314,1964,BEL,6004832166,5908101812,-96730354
315,1964,BEN,34836069,16786168,-18049901
316,1964,BFA,27084830,15082512,-12002318
317,1964,BGR,206785282,128059842,-78725440
318,1964,BHR,68007387,130361861,62354474
319,1964,BHS,143411697,25433526,-117978171
320,1964,BLZ,0,34595,34595
321,1964,BMU,83372425,28310329,-55062096
322,1964,BOL,91555809,89540491,-2015318
323,1964,BRA,1115231162,1540262109,425030947
324,1964,BRB,40058262,31665168,-8393094
325,1964,BRN,24278176,67299472,43021296
326,1964,CAF,24804487,29934558,5130071
327,1964,CAN,6818250494,7558413246,740162752
328,1964,CHE,3737298300,2604230985,-1133067315
329,1964,CHL,540875523,691793348,150917825
330,1964,CHN,847777287,1052392256,204614969
331,1964,CIV,229089127,335263793,106174666
332,1964,CMR,122427080,171569131,49142051
333,1964,COD,220341755,388071576,167729821
334,1964,COG,65758156,37491521,-28266635
335,1964,COK,1100,0,-1100
336,1964,COL,530748259,551882292,21134033
337,1964,COM,4186640,2022485,-2164155
338,1964,CPV,411099,0,-411099
339,1964,CRI,119682056,104980690,-14701366
340,1964,CUB,261560682,261230039,-330643
341,1964,CYP,82495875,57052240,-25443635
342,1964,DEU,14401689875,16981760224,2580070349
343,1964,DJI,26367940,1255878,-25112062
344,1964,DMA,381498,0,-381498
345,1964,DNK,2452541598,2045235821,-407305777
346,1964,DOM,197879007,186581859,-11297148
347,1964,DZA,668327587,761836985,93509398
348,1964,ECU,171245996,208382605,37136609
349,1964,EGY,684055672,275923561,-408132111
350,1964,ESP,2233590838,1128431389,-1105159449
351,1964,ETH,101707512,89433650,-12273862
352,1964,FIN,1170774313,1192525064,21750751
353,1964,FJI,49321875,40617471,-8704404
354,1964,FRA,9770549264,8756416540,-1014132724
355,1964,GAB,45167285,107460781,62293496
356,1964,GBR,13790390072,12079056831,-1711333241
357,1964,GHA,289680200,300015806,10335606
358,1964,GIB,8034272,14720,-8019552
359,1964,GIN,33599917,46226781,12626864
360,1964,GMB,11814680,11135069,-679611
361,1964,GNB,19179964,15419778,-3760186
362,1964,GNQ,9228045,4073171,-5154874
363,1964,GRC,899694074,281773708,-617920366
364,1964,GRL,1801999,0,-1801999
365,1964,GTM,180742494,182245024,1502530
366,1964,GUY,61336089,91694159,30358070
367,1964,HKG,1558666139,1046982679,-511683460
368,1964,HND,97313839,97394374,80535
369,1964,HTI,37155002,46627069,9472067
370,1964,HUN,357462161,316362068,-41100093
371,1964,IDN,489529941,726828667,237298726
372,1964,IND,2429833388,1488106023,-941727365
373,1964,IRL,888202453,629018277,-259184176
374,1964,IRN,636273717,1370541386,734267669
375,1964,IRQ,283142572,886442328,603299756
376,1964,ISL,107182505,100318536,-6863969
377,1964,ISR,731993791,359779128,-372214663
378,1964,ITA,6659084316,5529236785,-1129847531
379,1964,JAM,232935680,255780810,22845130
380,1964,JOR,133299269,23921666,-109377603
381,1964,JPN,6933019324,6142470657,-790548667
382,1964,KEN,240724744,186167814,-54556930
383,1964,KHM,65196563,92908040,27711477
384,1964,KOR,389347217,115451344,-273895873
385,1964,KWT,254533183,1617607268,1363074085
386,1964,LAO,27276708,2498490,-24778218
387,1964,LBN,363644856,143946299,-219698557
388,1964,LBR,399982422,170661667,-229320755
389,1964,LBY,282117439,793809972,511692533
390,1964,LKA,350565863,375253819,24687956
391,1964,MAC,149057,365559,216502
392,1964,MAR,458483504,497773964,39290460
393,1964,MDG,118022805,106097368,-11925437
394,1964,MDV,782161,0,-782161
395,1964,MEX,1580109566,1090351427,-489758139
396,1964,MLI,25017168,10397241,-14619927
397,1964,MLT,120018865,11766432,-108252433
398,1964,MMR,258958496,232640707,-26317789
399,1964,MNG,792855,4761144,3968289
400,1964,MOZ,128443544,113921720,-14521824
401,1964,MRT,15839357,56022526,40183169
402,1964,MUS,46822768,75697325,28874557
403,1964,MYS,1147439299,1277355440,129916141
404,1964,NCL,57241215,56147100,-1094115
405,1964,NER,41084745,31216529,-9868216
406,1964,NGA,629074545,622705985,-6368560
407,1964,NIC,112504848,117376739,4871891
408,1964,NLD,9234761179,6973402219,-2261358960
409,1964,NOR,1857805439,1284819275,-572986164
410,1964,NPL,30699394,8609215,-22090179
411,1964,NZL,893116998,1115298630,222181632
412,1964,OMN,46813210,123141366,76328156
413,1964,PAK,955060154,490194867,-464865287
414,1964,PAN,323756057,97259147,-226496910
415,1964,PER,541658652,775794335,234135683
416,1964,PHL,914546511,835660844,-78885667
417,1964,PNG,68145982,35680495,-32465487
418,1964,POL,728627309,695914607,-32712702
419,1964,PRK,20129326,21521999,1392673
420,1964,PRT,797361657,514293582,-283068075
421,1964,PRY,51548689,56896669,5347980
422,1964,PYF,22325828,5570174,-16755654
423,1964,QAT,45990132,155901147,109911015
424,1964,REU,65925817,37317484,-28608333
425,1964,ROU,313830778,261287382,-52543396
426,1964,RWA,1278753,100685,-1178068
427,1964,SAU,311298236,1014704195,703405959
428,1964,SDN,216694866,192817207,-23877659
429,1964,SEN,200064278,162557163,-37507115
430,1964,SGP,1007964782,217304010,-790660772
431,1964,SLE,87486590,50128867,-37357723
432,1964,SLV,191887709,169947744,-21939965
433,1964,SOM,27765530,16310496,-11455034
434,1964,SPM,4303441,1316324,-2987117
435,1964,SUR,65398911,49680081,-15718830
436,1964,SWE,3567131656,3471065766,-96065890
437,1964,SYC,300058,0,-300058
438,1964,SYR,132988926,174997299,42008373
439,1964,TCD,23962121,25083490,1121369
440,1964,TGO,37046457,34356187,-2690270
441,1964,THA,619341125,608442307,-10898818
442,1964,TLS,19817837,56143788,36325951
443,1964,TTO,283773892,269986975,-13786917
444,1964,TUN,235714804,176775695,-58939109
445,1964,TUR,534431238,410087170,-124344068
446,1964,TWN,445953857,475898210,29944353
447,1964,UGA,30284366,100730310,70445944
448,1964,URY,182547723,167115088,-15432635
449,1964,USA,18037988585,24888983438,6850994853
450,1964,VEN,1144788949,2574089642,1429300693
451,1964,VGB,46180,22030,-24150
452,1964,VIR,175790,2279,-173511
453,1964,VNM,301409410,57660866,-243748544
454,1964,VUT,30857549,49554358,18696809
455,1964,WSM,6707919,5908389,-799530
456,1964,YEM,2725658,3178514,452856
457,1964,ZAF,1974186269,1268112323,-706073946
458,1965,AGO,172028183,202290622,30262439
459,1965,ALB,18961298,3401818,-15559480
460,1965,AND,0,111429,111429
461,1965,ANT,805507168,664041981,-141465187
462,1965,ARG,1176851268,1659768832,482917564
463,1965,ATG,3699,1508,-2191
464,1965,AUS,3026114342,2947723777,-78390565
465,1965,AUT,1995540208,1441928351,-553611857
466,1965,BDI,23408398,30177685,6769287
467,1965,BEL,6758500028,6717624358,-40875670
468,1965,BEN,32169441,17667213,-14502228
469,1965,BFA,25927951,6830089,-19097862
470,1965,BGR,264193211,186691615,-77501596
471,1965,BHR,77000265,118707991,41707726
472,1965,BHS,173738666,25704385,-148034281
473,1965,BLZ,3600,0,-3600
474,1965,BMU,87309226,21664338,-65644888
475,1965,BOL,121642954,94199644,-27443310
476,1965,BRA,1026969403,1656920222,629950819
477,1965,BRB,44172216,27196449,-16975767
478,1965,BRN,31332834,73960574,42627740
479,1965,BTN,0,3039,3039
480,1965,CAF,22703238,30031882,7328644
481,1965,CAN,7912898688,8230735852,317837164
482,1965,CHE,3917005585,2918399645,-998605940
483,1965,CHL,622039556,837006344,214966788
484,1965,CHN,1166204692,1315614323,149409631
485,1965,CIV,213901137,328935442,115034305
486,1965,CMR,129766617,166282279,36515662
487,1965,COD,269852293,415648362,145796069
488,1965,COG,66347088,43780458,-22566630
489,1965,COL,423684556,600779368,177094812
490,1965,COM,4113090,2136500,-1976590
491,1965,CPV,1005898,0,-1005898
492,1965,CRI,157567975,122294249,-35273726
493,1965,CUB,202485631,160516465,-41969166
494,1965,CYP,115686199,71836490,-43849709
495,1965,DEU,16785525909,18878088026,2092562117
496,1965,DJI,31627008,513395,-31113613
497,1965,DMA,5196,8398,3202
498,1965,DNK,2619833552,2152399720,-467433832
499,1965,DOM,125580362,134614405,9034043
500,1965,DZA,662517145,741890645,79373500
501,1965,ECU,173691805,227171806,53480001
502,1965,EGY,775630689,395678603,-379952086
503,1965,ESP,2930482088,1172167740,-1758314348
504,1965,ETH,130392646,101214776,-29177870
505,1965,FIN,1306938659,1242988360,-63950299
506,1965,FJI,50665207,35802470,-14862737
507,1965,FRA,9997363386,9861410718,-135952668
508,1965,FRO,0,7691,7691
509,1965,GAB,52934884,117225874,64290990
510,1965,GBR,14442302708,13485679553,-956623155
511,1965,GHA,369340694,274304831,-95035863
512,1965,GIB,3210508,23846,-3186662
513,1965,GIN,45856148,52644629,6788481
514,1965,GMB,14016373,11619670,-2396703
515,1965,GNB,22512824,12178386,-10334438
516,1965,GNQ,13643237,2603928,-11039309
517,1965,GRC,1073149853,312562777,-760587076
518,1965,GRD,0,1511,1511
519,1965,GRL,2311898,0,-2311898
520,1965,GTM,223804479,201413620,-22390859
521,1965,GUY,74655922,84615621,9959699
522,1965,HKG,1616481321,1174451159,-442030162
523,1965,HND,113344814,141078895,27734081
524,1965,HTI,36975227,44981055,8005828
525,1965,HUN,370930546,360430389,-10500157
526,1965,IDN,515417314,755833409,240416095
527,1965,IND,2523936981,1550345305,-973591676
528,1965,IRL,963129000,671419121,-291709879
529,1965,IRN,807963431,1486366830,678403399
530,1965,IRQ,293585946,906837197,613251251
531,1965,ISL,123392155,110891489,-12500666
532,1965,ISR,736363793,420561416,-315802377
533,1965,ITA,6940335978,6768529325,-171806653
534,1965,JAM,252477410,254800052,2322642
535,1965,JOR,145970751,24299729,-121671022
536,1965,JPN,7262913993,7943124037,680210044
537,1965,KEN,252036384,154494886,-97541498
538,1965,KHM,75366504,94579223,19212719
539,1965,KOR,502946035,161711076,-341234959
540,1965,KWT,309834555,1600850318,1291015763
541,1965,LAO,33561229,2842453,-30718776
542,1965,LBN,397675538,108939208,-288736330
543,1965,LBR,591258510,207795524,-383462986
544,1965,LBY,368579398,1078797620,710218222
545,1965,LCA,0,30224,30224
546,1965,LKA,297132331,394919537,97787206
547,1965,MAC,0,12445,12445
548,1965,MAR,438558430,510059991,71501561
549,1965,MDG,122364808,104703575,-17661233
550,1965,MDV,861730,0,-861730
551,1965,MEX,1669022921,1254450828,-414572093
552,1965,MLI,32954503,7328770,-25625733
553,1965,MLT,109902797,16796845,-93105952
554,1965,MMR,223811974,220032427,-3779547
555,1965,MNG,756483,6939780,6183297
556,1965,MOZ,153567567,115994862,-37572705
557,1965,MRT,22667366,71749689,49082323
558,1965,MUS,53643473,69442547,15799074
559,1965,MWI,18218281,26993534,8775253
560,1965,MYS,1223294585,1406800200,183505615
561,1965,NCL,74452188,53693494,-20758694
562,1965,NER,30834922,21459792,-9375130
563,1965,NGA,666653179,758215865,91562686
564,1965,NIC,163574198,155147700,-8426498
565,1965,NLD,9975731197,7795151577,-2180579620
566,1965,NOR,2085063032,1471414968,-613648064
567,1965,NPL,35412462,25297796,-10114666
568,1965,NZL,989089369,1087525746,98436377
569,1965,OMN,55982965,184036744,128053779
570,1965,PAK,963316067,520510923,-442805144
571,1965,PAN,381924459,127011873,-254912586
572,1965,PER,709048192,818387609,109339417
573,1965,PHL,963299884,837271955,-126027929
574,1965,PNG,87361046,43944741,-43416305
575,1965,POL,731006522,791760046,60753524
576,1965,PRK,37488469,22888260,-14600209
577,1965,PRT,922271033,588051454,-334219579
578,1965,PRY,61564757,67464828,5900071
579,1965,PYF,44277791,15679406,-28598385
580,1965,QAT,64927201,148657008,83729807
581,1965,REU,70638346,36022563,-34615783
582,1965,ROU,374350593,327388625,-46961968
583,1965,RWA,1833203,597029,-1236174
584,1965,SAU,401543187,1195026954,793483767
585,1965,SDN,188805179,192963405,4158226
586,1965,SEN,193592300,165554850,-28037450
587,1965,SGP,1106500295,211399163,-895101132
588,1965,SLE,80114890,106332278,26217388
589,1965,SLV,192376991,201233169,8856178
590,1965,SOM,26171242,28423715,2252473
591,1965,SPM,4859203,1737748,-3121455
592,1965,SUR,80404687,53436067,-26968620
593,1965,SWE,4128273253,3778886704,-349386549
594,1965,SYC,254625,0,-254625
595,1965,SYR,138616175,174590339,35974164
596,1965,TCD,20893566,21584780,691214
597,1965,TGO,39716557,34306341,-5410216
598,1965,THA,656022044,654500196,-1521848
599,1965,TLS,17727608,23349124,5621516
600,1965,TTO,338522947,279167308,-59355639
601,1965,TUN,236678912,166369964,-70308948
602,1965,TUR,585606872,471058819,-114548053
603,1965,TWN,568403054,499606954,-68796100
604,1965,TZA,93964690,165058147,71093457
605,1965,UGA,53360281,127347675,73987394
606,1965,URY,122996835,193282104,70285269
607,1965,USA,21034676842,26054198507,5019521665
608,1965,VEN,1217070003,2837705985,1620635982
609,1965,VIR,411895,0,-411895
610,1965,VNM,409035911,47392757,-361643154
611,1965,VUT,34529955,56947612,22417657
612,1965,WSM,6144443,5312100,-832343
613,1965,YEM,4272093,3106042,-1166051
614,1965,ZAF,2235068946,1399106533,-835962413
615,1965,ZMB,131991762,488405946,356414184
616,1965,ZWE,163166439,213107765,49941326
617,1966,AGO,189979047,213391939,23412892
618,1966,ALB,19864678,4689231,-15175447
619,1966,AND,0,64903,64903
620,1966,ANT,733824029,604825203,-128998826
621,1966,ARG,1114935380,1776112393,661177013
622,1966,ATG,1091999,0,-1091999
623,1966,AUS,2883313930,3105276811,221962881
624,1966,AUT,2298939999,1511467368,-787472631
625,1966,BDI,13332879,19449555,6116676
626,1966,BEL,7551297455,7147022807,-404274648
627,1966,BEN,34949905,17490071,-17459834
628,1966,BFA,19951923,17863735,-2088188
629,1966,BGR,420359820,233326275,-187033545
630,1966,BHR,91770640,126055873,34285233
631,1966,BHS,203029359,31434969,-171594390
632,1966,BLZ,1604,5896,4292
633,1966,BMU,146647790,29279341,-117368449
634,1966,BOL,121030262,111050738,-9979524
635,1966,BRA,1436316226,1830237832,393921606
636,1966,BRB,51087764,26369452,-24718312
637,1966,BRN,44249002,83767205,39518203
638,1966,CAF,30830646,34238536,3407890
639,1966,CAN,9179157374,9822310230,643152856
640,1966,CHE,4233425828,3254632651,-978793177
641,1966,CHL,689100630,998480951,309380321
642,1966,CHN,1369162155,1631866456,262704301
643,1966,CIV,245321757,368476597,123154840
644,1966,CMR,134806678,177758191,42951513
645,1966,COD,241117764,540125127,299007363
646,1966,COG,68794918,56919235,-11875683
647,1966,COK,17100,7884,-9216
648,1966,COL,650524320,555082170,-95442150
649,1966,COM,4392386,2278380,-2114006
650,1966,CRI,163327964,142828599,-20499365
651,1966,CUB,230674596,161589863,-69084733
652,1966,CYP,123334019,85340454,-37993565
653,1966,DEU,17861982760,21594077620,3732094860
654,1966,DJI,33204811,857701,-32347110
655,1966,DMA,661697,1355,-660342
656,1966,DNK,2786438132,2361405674,-425032458
657,1966,DOM,160426563,142282505,-18144058
658,1966,DZA,626868848,837726773,210857925
659,1966,ECU,181314835,241643727,60328892
660,1966,EGY,827538049,375309598,-452228451
661,1966,ESP,3468510002,1424281664,-2044228338
662,1966,ETH,142427909,94286501,-48141408
663,1966,FIN,1406401858,1359056034,-47345824
664,1966,FJI,47481697,29768231,-17713466
665,1966,FRA,11470864655,10624330891,-846533764
666,1966,FRO,0,16900,16900
667,1966,GAB,54387729,118889225,64501496
668,1966,GBR,15057311956,14237368019,-819943937
669,1966,GHA,279428607,250947584,-28481023
670,1966,GIB,2092981,21302,-2071679
671,1966,GIN,39463780,48930679,9466899
672,1966,GMB,15309785,16838648,1528863
673,1966,GNB,23687134,12610144,-11076990
674,1966,GNQ,15626212,4099902,-11526310
675,1966,GRC,1155550395,394357431,-761192964
676,1966,GRL,1074499,3895,-1070604
677,1966,GTM,217136921,258463388,41326467
678,1966,GUY,87603908,96859918,9256010
679,1966,HKG,1888246551,1385704230,-502542321
680,1966,HND,137700535,171593968,33893433
681,1966,HTI,36770117,39962222,3192105
682,1966,HUN,449163086,412552575,-36610511
683,1966,IDN,495204044,829153380,333949336
684,1966,IND,2492760392,1478845206,-1013915186
685,1966,IRL,967834618,748748074,-219086544
686,1966,IRN,904335710,1623862281,719526571
687,1966,IRQ,368218255,926477105,558258850
688,1966,ISL,140060516,127719590,-12340926
689,1966,ISR,730436727,478002712,-252434015
690,1966,ITA,8212917979,7579218703,-633699276
691,1966,JAM,292147538,265386822,-26760716
692,1966,JOR,183246246,27923905,-155322341
693,1966,JPN,8502711522,9174873202,672161680
694,1966,KEN,286960373,174878626,-112081747
695,1966,KHM,82096185,63317868,-18778317
696,1966,KOR,733164431,230119647,-503044784
697,1966,KWT,399394194,1642249809,1242855615
698,1966,LAO,37836460,4121611,-33714849
699,1966,LBN,450905649,120787165,-330118484
700,1966,LBR,469573263,221249448,-248323815
701,1966,LBY,427901188,1199325200,771424012
702,1966,LKA,386123048,352028083,-34094965
703,1966,MAC,0,69729,69729
704,1966,MAR,456348766,498530429,42181663
705,1966,MDG,120444044,101160358,-19283686
706,1966,MDV,840881,0,-840881
707,1966,MEX,1809120265,1371024756,-438095509
708,1966,MLI,28545605,14259159,-14286446
709,1966,MLT,116070830,19057701,-97013129
710,1966,MMR,171295840,225314386,54018546
711,1966,MNG,1743153,7466008,5722855
712,1966,MOZ,189809826,118570508,-71239318
713,1966,MRT,24637746,82072346,57434600
714,1966,MUS,53761501,75178392,21416891
715,1966,MWI,64041882,48565842,-15476040
716,1966,MYS,1265575867,1389496213,123920346
717,1966,NCL,67617922,59233154,-8384768
718,1966,NER,30635371,35034231,4398860
719,1966,NGA,653224629,801300916,148076287
720,1966,NIC,176695724,147277866,-29417858
721,1966,NLD,10784830602,8659866838,-2124963764
722,1966,NOR,2269784626,1590987041,-678797585
723,1966,NPL,42431940,16061642,-26370298
724,1966,NZL,1004665294,1135488461,130823167
725,1966,OMN,75959427,222802511,146843084
726,1966,PAK,876882727,605204456,-271678271
727,1966,PAN,392857382,143408484,-249448898
728,1966,PER,799320801,840521516,41200715
729,1966,PHL,1004782961,980718098,-24064863
730,1966,PNG,102594031,41740208,-60853823
731,1966,POL,819949134,848633172,28684038
732,1966,PRK,29052153,32674069,3621916
733,1966,PRT,1013463386,632729489,-380733897
734,1966,PRY,70051093,60131065,-9920028
735,1966,PYF,38459107,15618514,-22840593
736,1966,QAT,65027856,186683845,121655989
737,1966,REU,90226703,47851752,-42374951
738,1966,ROU,473974546,390352923,-83621623
739,1966,RWA,8553624,4605946,-3947678
740,1966,SAU,472805663,1464355053,991549390
741,1966,SDN,201019773,201468011,448238
742,1966,SEN,187743959,177109205,-10634754
743,1966,SGP,1241840929,905698145,-336142784
744,1966,SLE,77435413,98497791,21062378
745,1966,SLV,215329489,183725639,-31603850
746,1966,SOM,32729677,22183288,-10546389
747,1966,SPM,5229503,1337338,-3892165
748,1966,SUR,68374840,98067050,29692210
749,1966,SWE,4262816998,4092083093,-170733905
750,1966,SYC,306074,0,-306074
751,1966,SYR,170066435,150095424,-19971011
752,1966,TCD,27703613,22005849,-5697764
753,1966,TGO,40581781,43661189,3079408
754,1966,THA,1153838524,748471799,-405366725
755,1966,TLS,19740287,25654665,5914378
756,1966,TTO,327877689,295553066,-32324623
757,1966,TUN,232833503,175357973,-57475530
758,1966,TUR,868242330,539664414,-328577916
759,1966,TWN,676065579,563819238,-112246341
760,1966,TZA,122529049,200660986,78131937
761,1966,UGA,60798873,152004540,91205667
762,1966,URY,133807397,211545238,77737841
763,1966,USA,24934004544,29549308193,4615303649
764,1966,VEN,1204046194,2699418171,1495371977
765,1966,VIR,8048600,1197,-8047403
766,1966,VNM,808255363,32950915,-775304448
767,1966,VUT,39346042,67485003,28138961
768,1966,WSM,6640913,2918426,-3722487
769,1966,YEM,8598388,4421529,-4176859
770,1966,ZAF,2174443750,1660395553,-514048197
771,1966,ZMB,359230782,654287302,295056520
772,1966,ZWE,75722312,172246718,96524406
773,1967,AGO,254183740,228592742,-25590998
774,1967,ALB,15275725,5418852,-9856873
775,1967,AND,0,9590,9590
776,1967,ANT,870634779,621375067,-249259712
777,1967,ARE,221338,350636,129298
778,1967,ARG,1076118511,1715143561,639025050
779,1967,ATG,1671297,0,-1671297
780,1967,AUS,3212637175,3416627541,203990366
781,1967,AUT,2252640898,1613777886,-638863012
782,1967,BDI,13189415,26281978,13092563
783,1967,BEL,7702466125,7336534761,-365931364
784,1967,BEN,41738387,18049457,-23688930
785,1967,BFA,28146118,18254468,-9891650
786,1967,BGR,399620894,256587270,-143033624
787,1967,BHR,98827068,127201620,28374552
788,1967,BHS,211971231,33726450,-178244781
789,1967,BLZ,3444,9227,5783
790,1967,BMU,108429837,34820693,-73609144
791,1967,BOL,136636708,145377903,8741195
792,1967,BRA,1591676007,1756996991,165320984
793,1967,BRB,68750529,27151420,-41599109
794,1967,BRN,42888799,97625051,54736252
795,1967,CAF,31306807,29472638,-1834169
796,1967,CAN,9825522615,10877134440,1051611825
797,1967,CHE,4438514899,3431076983,-1007437916
798,1967,CHL,734523438,1017880095,283356657
799,1967,CHN,1402921746,1571795101,168873355
800,1967,CIV,270591301,377803025,107211724
801,1967,CMR,163944628,183844301,19899673
802,1967,COD,221928901,497887860,275958959
803,1967,COG,76283010,82265603,5982593
804,1967,COL,450349086,554283730,103934644
805,1967,COM,4300614,2289733,-2010881
806,1967,CPV,1160800,0,-1160800
807,1967,CRI,170495595,155643176,-14852419
808,1967,CUB,224282547,156283045,-67999502
809,1967,CYM,0,1010,1010
810,1967,CYP,131391693,76622116,-54769577
811,1967,DEU,17099432638,23135237447,6035804809
812,1967,DJI,35295640,1215621,-34080019
813,1967,DMA,36897,0,-36897
814,1967,DNK,2911041657,2414892540,-496149117
815,1967,DOM,166993724,149558217,-17435507
816,1967,DZA,554739426,857851846,303112420
817,1967,ECU,230067071,265810736,35743665
818,1967,EGY,553045947,372464327,-180581620
819,1967,ESP,3411208123,1564970928,-1846237195
820,1967,ETH,133822722,106499915,-27322807
821,1967,FIN,1344274952,1347554779,3279827
822,1967,FJI,60415356,36368117,-24047239
823,1967,FRA,12063081482,11033587340,-1029494142
824,1967,FRO,0,13198,13198
825,1967,GAB,55627746,149509548,93881802
826,1967,GBR,15929034174,13943274781,-1985759393
827,1967,GHA,258504539,277252394,18747855
828,1967,GIB,735284,29323,-705961
829,1967,GIN,27249056,43116783,15867727
830,1967,GMB,16429572,24708972,8279400
831,1967,GNB,25742134,13417971,-12324163
832,1967,GNQ,10948938,3137348,-7811590
833,1967,GRC,1131395055,449663863,-681731192
834,1967,GRL,1395199,0,-1395199
835,1967,GTM,237684890,216572388,-21112502
836,1967,GUY,91684133,112071966,20387833
837,1967,HKG,1856622010,1594784242,-261837768
838,1967,HND,145858582,182381876,36523294
839,1967,HTI,37799088,40358533,2559445
840,1967,HUN,472387004,427328711,-45058293
841,1967,IDN,693624728,882516857,188892129
842,1967,IND,2457335626,1510444899,-946890727
843,1967,IRL,1019536959,852738596,-166798363
844,1967,IRN,1036509338,1988538735,952029397
845,1967,IRQ,299465487,817272156,517806669
846,1967,ISL,134802919,100677159,-34125760
847,1967,ISR,689104299,525585226,-163519073
848,1967,ITA,9141244821,8195437875,-945806946
849,1967,JAM,305021752,277713173,-27308579
850,1967,JOR,156734646,32468500,-124266146
851,1967,JPN,10243838854,9899838454,-344000400
852,1967,KEN,299226316,175656669,-123569647
853,1967,KHM,79954278,81750091,1795813
854,1967,KOR,994099889,298389599,-695710290
855,1967,KWT,468543010,1802830400,1334287390
856,1967,LAO,41633112,3625215,-38007897
857,1967,LBN,507506107,161116793,-346389314
858,1967,LBR,600250471,229539945,-370710526
859,1967,LBY,518566627,1372986145,854419518
860,1967,LKA,332290447,341383094,9092647
861,1967,MAC,0,9044,9044
862,1967,MAR,504479418,478043710,-26435708
863,1967,MDG,128038611,105617259,-22421352
864,1967,MEX,1975602281,1349612875,-625989406
865,1967,MLI,30022415,9095619,-20926796
866,1967,MLT,126325602,20957230,-105368372
867,1967,MMR,145623637,135133343,-10490294
868,1967,MNG,644185,5042838,4398653
869,1967,MOZ,206798691,167412757,-39385934
870,1967,MRT,36967840,88388113,51420273
871,1967,MUS,57372234,59998692,2626458
872,1967,MWI,65097659,55905281,-9192378
873,1967,MYS,1254417320,1341979266,87561946
874,1967,NCL,81432039,73668951,-7763088
875,1967,NER,37223347,39500794,2277447
876,1967,NGA,559086639,687549919,128463280
877,1967,NIC,192481702,153818736,-38662966
878,1967,NLD,11126538890,8960383921,-2166154969
879,1967,NOR,2616293736,1741469146,-874824590
880,1967,NPL,34844296,24864968,-9979328
881,1967,NZL,878673764,1053185260,174511496
882,1967,OMN,102119538,348011362,245891824
883,1967,PAK,1045613552,627698898,-417914654
884,1967,PAN,420904714,141022648,-279882066
885,1967,PER,743655390,815166556,71511166
886,1967,PHL,1260992151,926050007,-334942144
887,1967,PNG,119909387,42767452,-77141935
888,1967,POL,898405830,889632180,-8773650
889,1967,PRK,28838312,39570847,10732535
890,1967,PRT,1064160271,714292441,-349867830
891,1967,PRY,81045295,51102071,-29943224
892,1967,PYF,40803826,10204390,-30599436
893,1967,QAT,85779470,211002041,125222571
894,1967,REU,103807567,41431160,-62376407
895,1967,ROU,700038221,521289375,-178748846
896,1967,RWA,7290028,4947803,-2342225
897,1967,SAU,492711942,1748933737,1256221795
898,1967,SDN,216671005,216329834,-341171
899,1967,SEN,204996985,164285416,-40711569
900,1967,SGP,1389959552,937866329,-452093223
901,1967,SLE,68133560,107746217,39612657
902,1967,SLV,205084894,201614881,-3470013
903,1967,SOM,28014490,17569879,-10444611
904,1967,SPM,6209515,1753415,-4456100
905,1967,SUR,77675957,108939565,31263608
906,1967,SWE,4371468995,4351412098,-20056897
907,1967,SYC,0,1738,1738
908,1967,SYR,145487726,158640042,13152316
909,1967,TCD,26738121,17646933,-9091188
910,1967,TGO,40921797,38721194,-2200603
911,1967,THA,979780248,698151264,-281628984
912,1967,TLS,17781283,30893981,13112698
913,1967,TTO,359966703,335887834,-24078869
914,1967,TUN,231184231,176296573,-54887658
915,1967,TUR,726581164,532287945,-194293219
916,1967,TWN,838001998,674315968,-163686030
917,1967,TZA,126141606,205835018,79693412
918,1967,UGA,61802386,168244407,106442021
919,1967,URY,121930440,151826104,29895664
920,1967,USA,26318114794,30515331817,4197217023
921,1967,VEN,1222808624,2956614201,1733805577
922,1967,VIR,25077996,0,-25077996
923,1967,VNM,787039720,25702153,-761337567
924,1967,VUT,42286872,74064301,31777429
925,1967,WSM,6923046,2998524,-3924522
926,1967,YEM,14218717,2958113,-11260604
927,1967,ZAF,2403370665,1869979472,-533391193
928,1967,ZMB,440130828,645846519,205715691
929,1967,ZWE,58437415,91207827,32770412
930,1968,AGO,270231154,283923588,13692434
931,1968,ALB,18789106,7809035,-10980071
932,1968,AND,0,6237,6237
933,1968,ANT,792495071,622277022,-170218049
934,1968,ARE,7088870,5847176,-1241694
935,1968,ARG,1219092030,1506021494,286929464
936,1968,ATG,2837998,26682,-2811316
937,1968,AUS,3515848285,3408495685,-107352600
938,1968,AUT,2426640884,1772859426,-653781458
939,1968,BDI,16334255,26607801,10273546
940,1968,BEL,9009301330,8462817903,-546483427
941,1968,BEN,45759622,24283733,-21475889
942,1968,BFA,32705151,21612130,-11093021
943,1968,BGR,386667499,272131425,-114536074
944,1968,BHR,213070274,120385656,-92684618
945,1968,BHS,231136492,45579185,-185557307
946,1968,BLZ,8730,18155,9425
947,1968,BMU,140142904,45024458,-95118446
948,1968,BOL,147937003,129697759,-18239244
949,1968,BRA,2131176369,2043089515,-88086854
950,1968,BRB,85352992,29405759,-55947233
951,1968,BRN,64636123,116828784,52192661
952,1968,CAF,31246895,35016650,3769755
953,1968,CAN,11007625066,12853913777,1846288711
954,1968,CHE,4929930509,3885667119,-1044263390
955,1968,CHL,791694730,1077487628,285792898
956,1968,CHN,1286425184,1490256134,203830950
957,1968,CIV,304852215,487520175,182667960
958,1968,CMR,166345658,209779013,43433355
959,1968,COD,288404369,605209495,316805126
960,1968,COG,88825693,90748321,1922628
961,1968,COL,630661948,578786298,-51875650
962,1968,COM,4866177,3173041,-1693136
963,1968,CPV,1959268,7565,-1951703
964,1968,CRI,197980903,188561045,-9419858
965,1968,CUB,220958585,157918620,-63039965
966,1968,CYP,146110220,88658089,-57452131
967,1968,DEU,19642510569,26890920732,7248410163
968,1968,DJI,25269228,2076306,-23192922
969,1968,DMA,506299,0,-506299
970,1968,DNK,3067387576,2524406142,-542981434
971,1968,DOM,201553254,168554664,-32998590
972,1968,DZA,772691729,943024876,170333147
973,1968,ECU,243880970,257863555,13982585
974,1968,EGY,519091714,440815715,-78275999
975,1968,ESH,707692,1540,-706152
976,1968,ESP,3462281171,1763793443,-1698487728
977,1968,ETH,145927676,102852071,-43075605
978,1968,FIN,1280086728,1472597502,192510774
979,1968,FJI,69457909,31172702,-38285207
980,1968,FRA,13779754574,12211054035,-1568700539
981,1968,FRO,0,23125,23125
982,1968,GAB,59988536,157723392,97734856
983,1968,GBR,17425323546,14882909927,-2542413619
984,1968,GHA,275806344,344962905,69156561
985,1968,GIB,3509356,24569,-3484787
986,1968,GIN,24882062,44498428,19616366
987,1968,GMB,16873744,12602402,-4271342
988,1968,GNB,29343258,13417576,-15925682
989,1968,GNQ,12204681,2721873,-9482808
990,1968,GRC,1379643974,478077707,-901566267
991,1968,GRL,2688698,0,-2688698
992,1968,GTM,246751988,259049535,12297547
993,1968,GUY,91766849,114249910,22483061
994,1968,HKG,2125346612,1793985145,-331361467
995,1968,HND,168740362,215813233,47072871
996,1968,HTI,42133660,42471141,337481
997,1968,HUN,486484009,434255364,-52228645
998,1968,IDN,753564060,964557300,210993240
999,1968,IND,2096248342,1608534502,-487713840
1000,1968,IRL,1194628271,885537498,-309090773
1001,1968,IRN,1292300728,2113301744,821001016
1002,1968,IRQ,288743603,1006513834,717770231
1003,1968,ISL,112602962,74031340,-38571622
1004,1968,ISR,1037308077,625843089,-411464988
1005,1968,ITA,9817596611,9576704662,-240891949
1006,1968,JAM,350284470,263592183,-86692287
1007,1968,JOR,152033367,29721491,-122311876
1008,1968,JPN,11398886745,12364174600,965287855
1009,1968,KEN,292861034,163629922,-129231112
1010,1968,KHM,88308426,84658309,-3650117
1011,1968,KNA,0,12774,12774
1012,1968,KOR,1407130581,413222152,-993908429
1013,1968,KWT,487034874,2024573868,1537538994
1014,1968,LAO,40253096,4157141,-36095955
1015,1968,LBN,615064198,274475773,-340588425
1016,1968,LBR,666172674,230772455,-435400219
1017,1968,LBY,664231239,1923977151,1259745912
1018,1968,LKA,351773218,335518530,-16254688
1019,1968,MAC,0,25661,25661
1020,1968,MAR,517581087,471556499,-46024588
1021,1968,MDG,152750823,136953624,-15797199
1022,1968,MEX,2204506141,1509518675,-694987466
1023,1968,MLI,27293070,10510808,-16782262
1024,1968,MLT,134565083,24046315,-110518768
1025,1968,MMR,167611999,120290690,-47321309
1026,1968,MNG,1323542,4034177,2710635
1027,1968,MOZ,222336983,199339292,-22997691
1028,1968,MRT,39462911,84445220,44982309
1029,1968,MUS,52913653,71087073,18173420
1030,1968,MWI,62032728,60580773,-1451955
1031,1968,MYS,1239938616,1478205272,238266656
1032,1968,NCL,95118920,103243682,8124762
1033,1968,NER,42256636,39470534,-2786102
1034,1968,NGA,490909392,535906123,44996731
1035,1968,NIC,183087836,167553431,-15534405
1036,1968,NLD,12387067087,10624081833,-1762985254
1037,1968,NOR,2569784611,1947409665,-622374946
1038,1968,NPL,38154294,26722475,-11431819
1039,1968,NZL,855158650,1091253603,236094953
1040,1968,OMN,135996529,589389492,453392963
1041,1968,PAK,959727328,706386481,-253340847
1042,1968,PAN,506333686,154229473,-352104213
1043,1968,PER,626428107,942522167,316094060
1044,1968,PHL,1364012505,1033557230,-330455275
1045,1968,PNG,125747465,51787373,-73960092
1046,1968,POL,995575301,975030892,-20544409
1047,1968,PRK,46463958,52343754,5879796
1048,1968,PRT,1181812288,779295070,-402517218
1049,1968,PRY,88557049,52177690,-36379359
1050,1968,PYF,52551958,11689945,-40862013
1051,1968,QAT,126303881,321801008,195497127
1052,1968,REU,106068953,46166481,-59902472
1053,1968,ROU,730163704,539458215,-190705489
1054,1968,RWA,9424324,4464459,-4959865
1055,1968,SAU,739873789,2012685830,1272812041
1056,1968,SDN,247244873,237423081,-9821792
1057,1968,SEN,216465586,172383455,-44082131
1058,1968,SGP,1661896187,1015123441,-646772746
1059,1968,SLE,71445824,127211027,55765203
1060,1968,SLV,210374863,215873393,5498530
1061,1968,SOM,36974705,38774780,1800075
1062,1968,SPM,7436192,1237624,-6198568
1063,1968,SUR,83069117,125349058,42279941
1064,1968,SWE,4884784866,4734257986,-150526880
1065,1968,SYR,164133560,199147822,35014262
1066,1968,TCD,30591348,28702984,-1888364
1067,1968,TGO,41930683,50629304,8698621
1068,1968,THA,1092725006,658157587,-434567419
1069,1968,TLS,19106017,29834644,10728627
1070,1968,TTO,394381863,422908654,28526791
1071,1968,TUN,219963834,173360833,-46603001
1072,1968,TUR,771983571,546611041,-225372530
1073,1968,TWN,1130242353,802611289,-327631064
1074,1968,TZA,147651730,204282638,56630908
1075,1968,UGA,70008976,167348415,97339439
1076,1968,URY,150723103,173721299,22998196
1077,1968,USA,32421133681,33812798663,1391664982
1078,1968,VEN,1363723077,2842922925,1479199848
1079,1968,VIR,43647396,0,-43647396
1080,1968,VNM,772898800,20128029,-752770771
1081,1968,VUT,42480735,80412631,37931896
1082,1968,WSM,6613127,2800611,-3812516
1083,1968,YEM,9087651,5575928,-3511723
1084,1968,ZAF,2428481871,2011062120,-417419751
1085,1968,ZMB,270603028,722963095,452360067
1086,1968,ZWE,43210628,24953291,-18257337
1087,1969,AGO,311363251,346444311,35081060
1088,1969,ALB,21224084,7672992,-13551092
1089,1969,AND,0,3245,3245
1090,1969,ANT,832194358,642252862,-189941496
1091,1969,ARE,6974642,12576989,5602347
1092,1969,ARG,1671853913,1815887373,144033460
1093,1969,ATG,6088899,0,-6088899
1094,1969,AUS,3640717006,4177611717,536894711
1095,1969,AUT,2732907168,2148102363,-584804805
1096,1969,BDI,11625416,22450886,10825470
1097,1969,BEL,10288953113,9851010458,-437942655
1098,1969,BEN,53010916,29142246,-23868670
1099,1969,BFA,34079101,21558136,-12520965
1100,1969,BGR,356965264,257350078,-99615186
1101,1969,BHR,215964796,126765026,-89199770
1102,1969,BHS,252231337,58574503,-193656834
1103,1969,BLZ,9198,25083,15885
1104,1969,BMU,185911428,51096414,-134815014
1105,1969,BOL,170347682,158759581,-11588101
1106,1969,BRA,2185976584,2377672786,191696202
1107,1969,BRB,90645496,33020836,-57624660
1108,1969,BRN,65181194,111299444,46118250
1109,1969,BTN,0,1610,1610
1110,1969,CAF,33546916,38746151,5199235
1111,1969,CAN,12679840136,14245308273,1565468137
1112,1969,CHE,5702430802,4466724374,-1235706428
1113,1969,CHL,864431845,1231656177,367224332
1114,1969,CHN,1354779208,1594911952,240132744
1115,1969,CIV,312240621,548371793,236131172
1116,1969,CMR,193896696,240984907,47088211
1117,1969,COD,361309687,755504847,394195160
1118,1969,COG,69173188,82654398,13481210
1119,1969,COL,669639229,610992838,-58646391
1120,1969,COM,6952272,2731596,-4220676
1121,1969,CPV,4002565,12843,-3989722
1122,1969,CRI,229044801,205950135,-23094666
1123,1969,CUB,297282831,185195536,-112087295
1124,1969,CXR,0,2266828,2266828
1125,1969,CYM,6000,0,-6000
1126,1969,CYP,173820160,97368791,-76451369
1127,1969,DEU,23294810996,30620924601,7326113605
1128,1969,DJI,34655027,19421362,-15233665
1129,1969,DNK,3519724660,2883464020,-636260640
1130,1969,DOM,219558648,177116288,-42442360
1131,1969,DZA,933727227,972033502,38306275
1132,1969,ECU,247838367,249510533,1672166
1133,1969,EGY,623387171,492842598,-130544573
1134,1969,ESP,4063556430,2078470473,-1985085957
1135,1969,ETH,126419067,118723106,-7695961
1136,1969,FIN,1658897374,1735614401,76717027
1137,1969,FJI,76730001,56582651,-20147350
1138,1969,FRA,16645615951,14239037684,-2406578267
1139,1969,GAB,77145012,177680615,100535603
1140,1969,GBR,18020855854,16924791394,-1096064460
1141,1969,GHA,324936834,383285503,58348669
1142,1969,GIB,2374689,9632,-2365057
1143,1969,GIN,32964486,48742747,15778261
1144,1969,GMB,13472359,21312575,7840216
1145,1969,GNB,51602684,12274146,-39328538
1146,1969,GNQ,16908789,27149393,10240604
1147,1969,GRC,1679449820,554682791,-1124767029
1148,1969,GRD,3098,1568,-1530
1149,1969,GRL,0,7154,7154
1150,1969,GTM,257764394,275607687,17843293
1151,1969,GUY,97546517,127000093,29453576
1152,1969,HKG,2557510357,2223092021,-334418336
1153,1969,HND,172591223,213779384,41188161
1154,1969,HTI,48365459,44834700,-3530759
1155,1969,HUN,512123843,537886930,25763087
1156,1969,IDN,898063955,1183030485,284966530
1157,1969,IND,1718155680,1675768949,-42386731
1158,1969,IOT,540016,0,-540016
1159,1969,IRL,1404268158,1000113121,-404155037
1160,1969,IRN,1347073953,2055019445,707945492
1161,1969,IRQ,293789524,966278195,672488671
1162,1969,ISL,97834532,92764879,-5069653
1163,1969,ISR,1262359743,692304644,-570055099
1164,1969,ITA,11873370680,10854352786,-1019017894
1165,1969,JAM,413728487,298402271,-115326216
1166,1969,JOR,181801201,31065690,-150735511
1167,1969,JPN,13439534634,15218993147,1779458513
1168,1969,KEN,292698819,160007197,-132691622
1169,1969,KHM,91519515,64354594,-27164921
1170,1969,KNA,7531,0,-7531
1171,1969,KOR,1792960730,589403989,-1203556741
1172,1969,KWT,538570497,1995228430,1456657933
1173,1969,LAO,39138482,3785130,-35353352
1174,1969,LBN,600937482,278302028,-322635454
1175,1969,LBR,801602629,278986507,-522616122
1176,1969,LBY,701288174,2266134673,1564846499
1177,1969,LCA,3100,84456,81356
1178,1969,LKA,378269509,326874914,-51394595
1179,1969,MAC,2198,2485913,2483715
1180,1969,MAR,539757295,516910340,-22846955
1181,1969,MDG,155551968,123085550,-32466418
1182,1969,MDV,739608,5216,-734392
1183,1969,MEX,2303995111,1716487541,-587507570
1184,1969,MLI,27792490,14280128,-13512362
1185,1969,MLT,153888066,28920642,-124967424
1186,1969,MMR,149305396,138875138,-10430258
1187,1969,MNG,1099798,4205924,3106126
1188,1969,MOZ,251328643,182456172,-68872471
1189,1969,MRT,38199788,88439573,50239785
1190,1969,MUS,46890192,71786409,24896217
1191,1969,MWI,69174189,51624339,-17549850
1192,1969,MYS,1301188541,1855026290,553837749
1193,1969,NCL,129360174,127222803,-2137371
1194,1969,NER,38124289,35011918,-3112371
1195,1969,NGA,630169112,889121789,258952677
1196,1969,NIC,163220418,162268912,-951506
1197,1969,NLD,12219287447,9447057940,-2772229507
1198,1969,NOR,2697754553,2266555647,-431198906
1199,1969,NPL,44478676,30033419,-14445257
1200,1969,NZL,931752902,1266803522,335050620
1201,1969,OMN,158571080,525361971,366790891
1202,1969,PAK,880778088,672268061,-208510027
1203,1969,PAN,588928393,165735240,-423193153
1204,1969,PER,662635380,980286079,317650699
1205,1969,PHL,1398255495,1087237266,-311018229
1206,1969,PNG,180582637,63254396,-117328241
1207,1969,POL,1063133098,1039768021,-23365077
1208,1969,PRK,84874169,57846407,-27027762
1209,1969,PRT,1334405847,863409749,-470996098
1210,1969,PRY,87945075,61731878,-26213197
1211,1969,PYF,49414668,7919489,-41495179
1212,1969,QAT,120776436,333369221,212592785
1213,1969,REU,127142959,40669549,-86473410
1214,1969,ROU,756243828,570946374,-185297454
1215,1969,RWA,8445218,5232717,-3212501
1216,1969,SAU,821832673,2051953150,1230120477
1217,1969,SDN,204918623,250186372,45267749
1218,1969,SEN,234449712,162311779,-72137933
1219,1969,SGP,2064422860,1196817670,-867605190
1220,1969,SLE,83480655,131308037,47827382
1221,1969,SLV,203839991,204015414,175423
1222,1969,SOM,36785211,20031503,-16753708
1223,1969,SPM,8525022,1162963,-7362059
1224,1969,STP,1773439,134927,-1638512
1225,1969,SUR,85648428,127318945,41670517
1226,1969,SWE,5502975522,5362425437,-140550085
1227,1969,SYC,0,3612,3612
1228,1969,SYR,212379633,157327010,-55052623
1229,1969,TCD,32588465,23567405,-9021060
1230,1969,TGO,52264834,60650953,8386119
1231,1969,THA,1140651269,715230296,-425420973
1232,1969,TLS,21312495,39678000,18365505
1233,1969,TTO,441299409,428633466,-12665943
1234,1969,TUN,257142231,163326571,-93815660
1235,1969,TUR,841188890,532816103,-308372787
1236,1969,TWN,1404618833,1042590074,-362028759
1237,1969,TZA,138963706,207405560,68441854
1238,1969,UGA,73633530,159334592,85701062
1239,1969,URY,171702607,182234352,10531745
1240,1969,USA,35423517585,37378383680,1954866095
1241,1969,VEN,1459464765,2820464200,1360999435
1242,1969,VGB,2416,1497,-919
1243,1969,VIR,49638414,2556,-49635858
1244,1969,VNM,896668080,20931489,-875736591
1245,1969,VUT,46315879,83474604,37158725
1246,1969,WSM,9145432,3372473,-5772959
1247,1969,YEM,16167512,3857951,-12309561
1248,1969,ZAF,2730655318,2096706422,-633948896
1249,1969,ZMB,267439715,962970702,695530987
1250,1969,ZWE,12736416,17891198,5154782
1251,1970,AGO,354279592,453846965,99567373
1252,1970,ALB,25235250,9480449,-15754801
1253,1970,AND,41071304,1154722,-39916582
1254,1970,ANT,1031892250,666597171,-365295079
1255,1970,ARE,84689683,109572252,24882569
1256,1970,ARG,1799424163,2005680493,206256330
1257,1970,ATG,13219503,382966,-12836537
1258,1970,AUS,3968370190,4788341146,819970956
1259,1970,AUT,3432121813,2542499853,-889621960
1260,1970,BDI,17358801,27259249,9900448
1261,1970,BEL,11876960050,11380294416,-496665634
1262,1970,BEN,61963137,38392564,-23570573
1263,1970,BFA,35502145,25445723,-10056422
1264,1970,BGR,413237884,317068425,-96169459
1265,1970,BHR,180641470,185985164,5343694
1266,1970,BHS,292868393,101912073,-190956320
1267,1970,BLZ,23606612,15305929,-8300683
1268,1970,BMU,228654667,63113954,-165540713
1269,1970,BOL,150699599,168734466,18034867
1270,1970,BRA,2653371885,2856983826,203611941
1271,1970,BRB,112821469,38525882,-74295587
1272,1970,BRN,86963641,113639138,26675497
1273,1970,BTN,10443,5254,-5189
1274,1970,CAF,38349644,51614366,13264722
1275,1970,CAN,12733117809,16503791976,3770674167
1276,1970,CCK,715144,0,-715144
1277,1970,CHE,6867491614,4941667571,-1925824043
1278,1970,CHL,888932642,1402011722,513079080
1279,1970,CHN,1641705744,1602156035,-39549709
1280,1970,CIV,385105914,579985910,194879996
1281,1970,CMR,224928369,239750219,14821850
1282,1970,COD,524138800,823220414,299081614
1283,1970,COG,84621940,76154770,-8467170
1284,1970,COK,732633,4797,-727836
1285,1970,COL,829437760,736865564,-92572196
1286,1970,COM,10634547,14676928,4042381
1287,1970,CPV,11944805,1336600,-10608205
1288,1970,CRI,287507426,280578567,-6928859
1289,1970,CUB,388956781,256710064,-132246717
1290,1970,CXR,3537423,11429997,7892574
1291,1970,CYM,1645776,58148,-1587628
1292,1970,CYP,210972158,112209999,-98762159
1293,1970,DEU,28790448374,35841901553,7051453179
1294,1970,DJI,27954591,1010811,-26943780
1295,1970,DMA,24900632,21814779,-3085853
1296,1970,DNK,4073133800,3195220573,-877913227
1297,1970,DOM,294407418,220001525,-74405893
1298,1970,DZA,1143373062,1100837397,-42535665
1299,1970,ECU,299442508,309225440,9782932
1300,1970,EGY,797154969,562954583,-234200386
1301,1970,ESH,110698959,18847567,-91851392
1302,1970,ESP,4432482992,2464930551,-1967552441
1303,1970,ETH,162247258,145071842,-17175416
1304,1970,FIN,2212492596,2071541729,-140950867
1305,1970,FJI,95224042,64216574,-31007468
1306,1970,FLK,962128,1530703,568575
1307,1970,FRA,18280211540,17057367305,-1222844235
1308,1970,FRO,2215638,2824724,609086
1309,1970,GAB,85217831,183537989,98320158
1310,1970,GBR,19182702571,18087674142,-1095028429
1311,1970,GHA,369258054,402211864,32953810
1312,1970,GIB,33946115,2876939,-31069176
1313,1970,GIN,51503592,77453635,25950043
1314,1970,GMB,16509239,17013854,504615
1315,1970,GNB,34601297,10168810,-24432487
1316,1970,GNQ,25609174,24829156,-780018
1317,1970,GRC,2033250826,647309914,-1385940912
1318,1970,GRD,4241759,210808,-4030951
1319,1970,GRL,6332085,2432357,-3899728
1320,1970,GTM,291127104,315342663,24215559
1321,1970,GUY,113635410,160925011,47289601
1322,1970,HKG,2914796590,2538742131,-376054459
1323,1970,HND,207120662,198889994,-8230668
1324,1970,HTI,68094204,51571818,-16522386
1325,1970,HUN,754548530,642102303,-112446227
1326,1970,IDN,1136213109,1464523991,328310882
1327,1970,IND,1863670571,1778890476,-84780095
1328,1970,IOT,7005,0,-7005
1329,1970,IRL,1631787339,1118816455,-512970884
1330,1970,IRN,1500365382,2477921665,977556283
1331,1970,IRQ,347849504,985383043,637533539
1332,1970,ISL,142958745,145665083,2706338
1333,1970,ISR,1392790891,763728771,-629062120
1334,1970,ITA,14335345583,12240889577,-2094456006
1335,1970,JAM,479572527,356678045,-122894482
1336,1970,JOR,170366290,38074771,-132291519
1337,1970,JPN,16458947533,18445303048,1986355515
1338,1970,KEN,335910083,209351338,-126558745
1339,1970,KHM,49851267,44353451,-5497816
1340,1970,KIR,4323773,6003136,1679363
1341,1970,KNA,64553544,13706004,-50847540
1342,1970,KOR,1842413597,817518677,-1024894920
1343,1970,KWT,555118973,2144576368,1589457395
1344,1970,LAO,46695118,5313189,-41381929
1345,1970,LBN,601782601,240472285,-361310316
1346,1970,LBR,1033753901,320393424,-713360477
1347,1970,LBY,577225612,2667231171,2090005559
1348,1970,LCA,3954694,1040556,-2914138
1349,1970,LKA,341141149,342063580,922431
1350,1970,MAC,20735271,55066735,34331464
1351,1970,MAR,639360860,563345179,-76015681
1352,1970,MDG,153665445,163405833,9740388
1353,1970,MDV,2050847,6456349,4405502
1354,1970,MEX,2692781211,1711459876,-981321335
1355,1970,MLI,48260708,41828733,-6431975
1356,1970,MLT,145382316,28027262,-117355054
1357,1970,MMR,150447838,131980981,-18466857
1358,1970,MNG,947488,2384739,1437251
1359,1970,MOZ,291445901,211673476,-79772425
1360,1970,MRT,44880031,103801502,58921471
1361,1970,MSR,452991,3208,-449783
1362,1970,MUS,75311499,74230480,-1081019
1363,1970,MWI,79774493,58829374,-20945119
1364,1970,MYS,1421535558,1922005051,500469493
1365,1970,NCL,205227905,205656354,428449
1366,1970,NER,52785998,33562810,-19223188
1367,1970,NGA,886889053,1307475257,420586204
1368,1970,NIC,202253861,180702733,-21551128
1369,1970,NIU,185543,78520,-107023
1370,1970,NLD,14814470251,11080255099,-3734215152
1371,1970,NOR,3476186970,3448099611,-28087359
1372,1970,NPL,50448902,23810525,-26638377
1373,1970,NRU,4565183,34003871,29438688
1374,1970,NZL,1120401878,1298537077,178135199
1375,1970,OMN,61901231,447923287,386022056
1376,1970,PAK,1085990088,674682938,-411307150
1377,1970,PAN,652732680,183383529,-469349151
1378,1970,PCN,3750,0,-3750
1379,1970,PER,674303847,1108078001,433774154
1380,1970,PHL,1324404820,1200554346,-123850474
1381,1970,PNG,239979523,70699827,-169279696
1382,1970,POL,1108400902,1229089493,120688591
1383,1970,PRK,54101792,64461838,10360046
1384,1970,PRT,1619592094,946222964,-673369130
1385,1970,PRY,86176467,76320493,-9855974
1386,1970,PYF,56319105,5336435,-50982670
1387,1970,QAT,136215290,391083483,254868193
1388,1970,REU,137331888,51707721,-85624167
1389,1970,ROU,824998324,715541217,-109457107
1390,1970,RWA,12515639,7456952,-5058687
1391,1970,SAU,674436496,2269719876,1595283380
1392,1970,SDN,242180072,263601450,21421378
1393,1970,SEN,195555167,162990726,-32564441
1394,1970,SGP,2414553314,1255769727,-1158783587
1395,1970,SHN,2307088,764282,-1542806
1396,1970,SLB,12744182,7797932,-4946250
1397,1970,SLE,84333667,52215949,-32117718
1398,1970,SLV,221530407,235900503,14370096
1399,1970,SOM,45076123,36287538,-8788585
1400,1970,SPM,9309627,1847838,-7461789
1401,1970,STP,7927208,2321855,-5605353
1402,1970,SUR,91187261,152180193,60992932
1403,1970,SWE,6569927403,6457914259,-112013144
1404,1970,SYC,6289353,4474355,-1814998
1405,1970,SYR,206032564,176558638,-29473926
1406,1970,TCA,38921,2607,-36314
1407,1970,TCD,42012954,33148283,-8864671
1408,1970,TGO,59132658,62649970,3517312
1409,1970,THA,1178526381,744900142,-433626239
1410,1970,TKL,0,2701,2701
1411,1970,TLS,6582377,789858,-5792519
1412,1970,TON,4459221,1166344,-3292877
1413,1970,TTO,515133921,448271853,-66862068
1414,1970,TUN,289410569,191438609,-97971960
1415,1970,TUR,938558253,618203212,-320355041
1416,1970,TWN,1554830926,1443341211,-111489715
1417,1970,TZA,166342747,223409775,57067028
1418,1970,UGA,76276229,200204251,123928022
1419,1970,URY,245820915,203242090,-42578825
1420,1970,USA,38889165620,41940776910,3051611290
1421,1970,VCT,3021920,729893,-2292027
1422,1970,VEN,1637929998,3075267126,1437337128
1423,1970,VGB,559234,13503,-545731
1424,1970,VIR,390345630,1858814,-388486816
1425,1970,VNM,820753882,23414989,-797338893
1426,1970,VUT,13930146,10784877,-3145269
1427,1970,WLF,726887,0,-726887
1428,1970,WSM,12360000,3878837,-8481163
1429,1970,YEM,33144284,7235365,-25908919
1430,1970,ZAF,3266286436,1999793441,-1266492995
1431,1970,ZMB,460049111,1088585172,628536061
1432,1970,ZWE,16558899,59035718,42476819
1433,1971,AGO,411150034,489865853,78715819
1434,1971,ALB,24211823,15637566,-8574257
1435,1971,AND,50628268,1732423,-48895845
1436,1971,ANT,895105200,663750908,-231354292
1437,1971,ARE,113022241,168932125,55909884
1438,1971,ARG,1827065801,1931711263,104645462
1439,1971,ATG,13707162,264320,-13442842
1440,1971,AUS,4230253677,5212920152,982666475
1441,1971,AUT,3924491123,2828880785,-1095610338
1442,1971,BDI,15885364,20022506,4137142
1443,1971,BEL,12930813828,12137858227,-792955601
1444,1971,BEN,76245752,44504648,-31741104
1445,1971,BFA,36990474,18821393,-18169081
1446,1971,BGR,420702161,321496670,-99205491
1447,1971,BHR,293647601,202313211,-91334390
1448,1971,BHS,237901243,280683999,42782756
1449,1971,BLZ,27280394,19018295,-8262099
1450,1971,BMU,168391536,76570092,-91821444
1451,1971,BOL,137626336,142120186,4493850
1452,1971,BRA,3370496252,3027031367,-343464885
1453,1971,BRB,129149726,35092629,-94057097
1454,1971,BRN,138349233,153490324,15141091
1455,1971,BTN,31929,4749,-27180
1456,1971,CAF,37749352,49948820,12199468
1457,1971,CAN,14942241128,17940365334,2998124206
1458,1971,CCK,841886,2400,-839486
1459,1971,CHE,7478669297,5578867911,-1899801386
1460,1971,CHL,953905516,1123324965,169419449
1461,1971,CHN,1582662014,1811940556,229278542
1462,1971,CIV,405508634,565040967,159532333
1463,1971,CMR,219440158,231203484,11763326
1464,1971,COD,544326262,592225132,47898870
1465,1971,COG,106278401,79585805,-26692596
1466,1971,COK,754287,14173,-740114
1467,1971,COL,855396747,691086568,-164310179
1468,1971,COM,7104219,3262760,-3841459
1469,1971,CPV,17164595,1488912,-15675683
1470,1971,CRI,316296785,268283208,-48013577
1471,1971,CUB,374627195,283978326,-90648869
1472,1971,CXR,3482006,10301845,6819839
1473,1971,CYM,2377503,950227,-1427276
1474,1971,CYP,243238018,114646474,-128591544
1475,1971,DEU,31257338660,37341050829,6083712169
1476,1971,DJI,35793511,998976,-34794535
1477,1971,DMA,31206866,19272729,-11934137
1478,1971,DNK,4351501212,3500020295,-851480917
1479,1971,DOM,348451012,235123641,-113327371
1480,1971,DZA,1204105381,905396183,-298709198
1481,1971,ECU,346749642,286006039,-60743603
1482,1971,EGY,819797014,570541146,-249255868
1483,1971,ESH,31765060,5205135,-26559925
1484,1971,ESP,4761754074,2988879284,-1772874790
1485,1971,ETH,171718368,139920385,-31797983
1486,1971,FIN,2279854538,2181254002,-98600536
1487,1971,FJI,117734363,62010506,-55723857
1488,1971,FLK,5542523,2037240,-3505283
1489,1971,FRA,20007538256,19732664997,-274873259
1490,1971,FRO,2317088,4245375,1928287
1491,1971,GAB,93270324,227726950,134456626
1492,1971,GBR,21049700497,21045964883,-3735614
1493,1971,GHA,401432650,364075669,-37356981
1494,1971,GIB,37379256,5849441,-31529815
1495,1971,GIN,59878079,71876283,11998204
1496,1971,GMB,19739357,20122396,383039
1497,1971,GNB,36387742,8923853,-27463889
1498,1971,GNQ,23751675,24455772,704097
1499,1971,GRC,2192468511,689306107,-1503162404
1500,1971,GRD,4754403,148112,-4606291
1501,1971,GRL,3152449,3448410,295961
1502,1971,GTM,293488627,315736629,22248002
1503,1971,GUY,118334056,193760283,75426227
1504,1971,HKG,3258311330,2864091370,-394219960
1505,1971,HND,168807165,213090379,44283214
1506,1971,HTI,72782410,58173845,-14608565
1507,1971,HUN,844998530,601638145,-243360385
1508,1971,IDN,1341806310,1642689983,300883673
1509,1971,IND,2183501873,1831614691,-351887182
1510,1971,IOT,0,6606,6606
1511,1971,IRL,2082237778,1318739251,-763498527
1512,1971,IRN,1842123851,4704714713,2862590862
1513,1971,IRQ,486615482,1278314911,791699429
1514,1971,ISL,187085273,146744228,-40341045
1515,1971,ISR,1682574853,941481206,-741093647
1516,1971,ITA,14860769460,14053155579,-807613881
1517,1971,JAM,506464522,370836004,-135628518
1518,1971,JOR,199058593,32457636,-166600957
1519,1971,JPN,16906241732,22686062314,5779820582
1520,1971,KEN,413238564,230906368,-182332196
1521,1971,KHM,69720943,10686470,-59034473
1522,1971,KIR,4482714,8774775,4292061
1523,1971,KNA,58106319,13934909,-44171410
1524,1971,KOR,2188211971,987463380,-1200748591
1525,1971,KWT,581290988,2852512971,2271221983
1526,1971,LAO,49981219,5486255,-44494964
1527,1971,LBN,757258280,328600061,-428658219
1528,1971,LBR,1374789828,347605724,-1027184104
1529,1971,LBY,737575598,2740577064,2003001466
1530,1971,LCA,5846468,661026,-5185442
1531,1971,LKA,330932456,345186405,14253949
1532,1971,MAC,29367513,68735717,39368204
1533,1971,MAR,674944823,557385688,-117559135
1534,1971,MDG,183862782,178242098,-5620684
1535,1971,MDV,1427899,3165180,1737281
1536,1971,MEX,2633301762,1803702905,-829598857
1537,1971,MLI,56872678,35415728,-21456950
1538,1971,MLT,144359537,33071136,-111288401
1539,1971,MMR,181339037,131681808,-49657229
1540,1971,MNG,1383531,2689043,1305512
1541,1971,MOZ,301019234,211977001,-89042233
1542,1971,MRT,52410431,114760709,62350278
1543,1971,MSR,543258,4132,-539126
1544,1971,MUS,85836617,66123198,-19713419
1545,1971,MWI,84126672,70967608,-13159064
1546,1971,MYS,1523118802,1884904263,361785461
1547,1971,NCL,185810111,207319898,21509787
1548,1971,NER,45185742,51697747,6512005
1549,1971,NGA,1254855614,1763157772,508302158
1550,1971,NIC,193977926,195404856,1426930
1551,1971,NIU,169942,4227,-165715
1552,1971,NLD,15924625265,12780294672,-3144330593
1553,1971,NOR,3824955457,3514581900,-310373557
1554,1971,NPL,39467450,18167704,-21299746
1555,1971,NRU,6543989,27630355,21086366
1556,1971,NZL,1219129660,1455098780,235969120
1557,1971,OMN,103076828,539955326,436878498
1558,1971,PAK,915812353,674730990,-241081363
1559,1971,PAN,765955808,325653932,-440301876
1560,1971,PCN,40786,2668,-38118
1561,1971,PER,828506774,950066252,121559478
1562,1971,PHL,1400637992,1282965281,-117672711
1563,1971,PNG,268791124,78273181,-190517943
1564,1971,POL,1263302570,1359531928,96229358
1565,1971,PRK,59286838,66479885,7193047
1566,1971,PRT,1820382503,1022537343,-797845160
1567,1971,PRY,99306772,73676446,-25630326
1568,1971,PYF,54413875,2980011,-51433864
1569,1971,QAT,194875265,602905976,408030711
1570,1971,REU,138976501,44188541,-94787960
1571,1971,ROU,871768525,771091752,-100676773
1572,1971,RWA,15653343,16515918,862575
1573,1971,SAU,769518021,3671376622,2901858601
1574,1971,SDN,287581904,278041369,-9540535
1575,1971,SEN,218032654,144479244,-73553410
1576,1971,SGP,2761494365,1525333673,-1236160692
1577,1971,SHN,3308228,2520072,-788156
1578,1971,SLB,17183021,13249098,-3933923
1579,1971,SLE,85408789,68057306,-17351483
1580,1971,SLV,229204263,234319772,5115509
1581,1971,SOM,74595581,13281052,-61314529
1582,1971,SPM,9719360,1112589,-8606771
1583,1971,STP,4808573,2781469,-2027104
1584,1971,SUR,100089961,177552840,77462879
1585,1971,SWE,6620190811,7093361251,473170440
1586,1971,SYC,14953650,5681832,-9271818
1587,1971,SYR,280573309,186600199,-93973110
1588,1971,TCA,58880,1504,-57376
1589,1971,TCD,43372447,27335287,-16037160
1590,1971,TGO,69744484,61804294,-7940190
1591,1971,THA,1167875351,856642982,-311232369
1592,1971,TKL,0,2945,2945
1593,1971,TLS,5779553,2235470,-3544083
1594,1971,TON,6313046,1279055,-5033991
1595,1971,TTO,747825393,474279672,-273545721
1596,1971,TUN,330577922,232909798,-97668124
1597,1971,TUR,1069855962,708500188,-361355774
1598,1971,TWN,3163379671,1978179306,-1185200365
1599,1971,TZA,184058407,206477346,22418939
1600,1971,UGA,122583742,172012674,49428932
1601,1971,URY,234971224,219408227,-15562997
1602,1971,USA,44120016052,42581034087,-1538981965
1603,1971,VCT,3450372,404184,-3046188
1604,1971,VEN,1780846944,3122860541,1342013597
1605,1971,VGB,1772719,60185,-1712534
1606,1971,VIR,499949639,3948011,-496001628
1607,1971,VNM,802688746,22626619,-780062127
1608,1971,VUT,18468524,8125595,-10342929
1609,1971,WLF,820550,1685,-818865
1610,1971,WSM,13484248,3230990,-10253258
1611,1971,YEM,44197762,7744245,-36453517
1612,1971,ZAF,3618329276,2015094234,-1603235042
1613,1971,ZMB,708551672,704814859,-3736813
1614,1971,ZWE,16732939,50751166,34018227
1615,1972,AGO,359210525,570928221,211717696
1616,1972,ALB,26040090,13544811,-12495279
1617,1972,AND,76094439,2184554,-73909885
1618,1972,ANT,885413374,659066365,-226347009
1619,1972,ARE,351879549,891269878,539390329
1620,1972,ARG,1871529619,2036910072,165380453
1621,1972,ATG,12780308,619552,-12160756
1622,1972,AUS,4140034862,6378444155,2238409293
1623,1972,AUT,5085588868,3552804579,-1532784289
1624,1972,BDI,17910367,22986210,5075843
1625,1972,BEL,15718453154,15731805736,13352582
1626,1972,BEN,89012373,42135439,-46876934
1627,1972,BFA,51638374,22339030,-29299344
1628,1972,BGD,308399133,79922941,-228476192
1629,1972,BGR,463980336,347866932,-116113404
1630,1972,BHR,382066172,216496095,-165570077
1631,1972,BHS,458216673,288831256,-169385417
1632,1972,BLZ,34266446,22701374,-11565072
1633,1972,BMU,129373093,33390242,-95982851
1634,1972,BOL,188882900,174211924,-14670976
1635,1972,BRA,4532320101,4059490629,-472829472
1636,1972,BRB,116049457,33624956,-82424501
1637,1972,BRN,91628911,146903993,55275082
1638,1972,BTN,1730147,315512,-1414635
1639,1972,CAF,40233777,60197123,19963346
1640,1972,CAN,18032118643,20951863490,2919744847
1641,1972,CCK,1034113,6888,-1027225
1642,1972,CHE,9356608181,6677498917,-2679109264
1643,1972,CHL,1043906959,892030721,-151876238
1644,1972,CHN,2000022115,2414302932,414280817
1645,1972,CIV,480228901,674805578,194576677
1646,1972,CMR,271980602,245801446,-26179156
1647,1972,COD,628923511,683236670,54313159
1648,1972,COG,109576738,111816132,2239394
1649,1972,COK,788278,7777,-780501
1650,1972,COL,840931593,851392678,10461085
1651,1972,COM,13363751,3384151,-9979600
1652,1972,CPV,20894236,1763842,-19130394
1653,1972,CRI,335715011,322137872,-13577139
1654,1972,CUB,320925254,330124740,9199486
1655,1972,CXR,2856612,11739264,8882652
1656,1972,CYM,5484228,107461,-5376767
1657,1972,CYP,338944782,131624685,-207320097
1658,1972,DEU,39046036858,47606921122,8560884264
1659,1972,DJI,41337808,3068588,-38269220
1660,1972,DMA,28416714,24119986,-4296728
1661,1972,DNK,4874071274,4190476067,-683595207
1662,1972,DOM,388930908,349469578,-39461330
1663,1972,DZA,1414927658,1260708224,-154219434
1664,1972,ECU,347944718,373646678,25701960
1665,1972,EGY,831566708,512267678,-319299030
1666,1972,ESH,37940541,10792457,-27148084
1667,1972,ESP,6568897161,3824866096,-2744031065
1668,1972,ETH,174358609,170932392,-3426217
1669,1972,FIN,2703809104,2611069026,-92740078
1670,1972,FJI,144933329,67606253,-77327076
1671,1972,FLK,735266,1811203,1075937
1672,1972,FRA,25390758618,24962510826,-428247792
1673,1972,FRO,2638314,3243081,604767
1674,1972,GAB,140352224,257275436,116923212
1675,1972,GBR,25113018592,22955813733,-2157204859
1676,1972,GHA,244637762,377248714,132610952
1677,1972,GIB,37558764,2700590,-34858174
1678,1972,GIN,65607423,57801669,-7805754
1679,1972,GMB,22238279,22820900,582621
1680,1972,GNB,38880100,7778466,-31101634
1681,1972,GNQ,26510126,22761267,-3748859
1682,1972,GRC,2789336062,937574450,-1851761612
1683,1972,GRD,5501447,450440,-5051007
1684,1972,GRL,12390459,6349850,-6040609
1685,1972,GTM,322362432,372389361,50026929
1686,1972,GUY,122697456,169396845,46699389
1687,1972,HKG,3935368254,3551591533,-383776721
1688,1972,HND,176270576,234583930,58313354
1689,1972,HTI,95064304,69700594,-25363710
1690,1972,HUN,958854537,882149495,-76705042
1691,1972,IDN,1755944978,2138435584,382490606
1692,1972,IND,2089144185,2176343565,87199380
1693,1972,IOT,17909,5242,-12667
1694,1972,IRL,2061926177,1588616777,-473309400
1695,1972,IRN,2343840395,5770026747,3426186352
1696,1972,IRQ,642332962,1200609497,558276535
1697,1972,ISL,212521100,164164963,-48356137
1698,1972,ISR,1786729293,1144944283,-641785010
1699,1972,ITA,18305267821,17431348754,-873919067
1700,1972,JAM,566564896,425913908,-140650988
1701,1972,JOR,245913015,49113051,-196799964
1702,1972,JPN,20817507901,27502262692,6684754791
1703,1972,KEN,377435752,268405601,-109030151
1704,1972,KHM,106294013,5798003,-100496010
1705,1972,KIR,5078963,9644718,4565755
1706,1972,KNA,63388403,15432783,-47955620
1707,1972,KOR,2368019059,1546645573,-821373486
1708,1972,KWT,725314993,3176904746,2451589753
1709,1972,LAO,50253156,7401307,-42851849
1710,1972,LBN,962638025,437799825,-524838200
1711,1972,LBR,1731546449,386927118,-1344619331
1712,1972,LBY,1145467720,2687679658,1542211938
1713,1972,LCA,7229618,1341365,-5888253
1714,1972,LKA,313866339,336762402,22896063
1715,1972,MAC,33182997,90225193,57042196
1716,1972,MAR,727343516,671142160,-56201356
1717,1972,MDG,167421791,181651472,14229681
1718,1972,MDV,1880816,3402693,1521877
1719,1972,MEX,3229353109,2274122236,-955230873
1720,1972,MLI,69976668,27462774,-42513894
1721,1972,MLT,146434492,50377878,-96056614
1722,1972,MMR,158135524,142170612,-15964912
1723,1972,MNG,1611287,3456009,1844722
1724,1972,MOZ,318525382,284808876,-33716506
1725,1972,MRT,78573088,131563941,52990853
1726,1972,MSR,25677132,3896873,-21780259
1727,1972,MUS,111218651,107777434,-3441217
1728,1972,MWI,103420984,78962517,-24458467
1729,1972,MYS,1710724917,2081305975,370581058
1730,1972,NCL,183938787,220689559,36750772
1731,1972,NER,62949707,42487471,-20462236
1732,1972,NGA,1324397504,2255779316,931381812
1733,1972,NIC,214621952,253730592,39108640
1734,1972,NIU,249670,5158,-244512
1735,1972,NLD,18808560462,16200289850,-2608270612
1736,1972,NOR,4123401692,4405262868,281861176
1737,1972,NPL,61418836,28669168,-32749668
1738,1972,NRU,6133336,20993793,14860457
1739,1972,NZL,1356352063,1857556727,501204664
1740,1972,OMN,110526401,308208162,197681761
1741,1972,PAK,805752341,701231615,-104520726
1742,1972,PAN,1077214362,239875550,-837338812
1743,1972,PCN,17951,0,-17951
1744,1972,PER,928916143,1040127446,111211303
1745,1972,PHL,1420521087,1224665169,-195855918
1746,1972,PNG,243223182,169781626,-73441556
1747,1972,POL,1996632751,1722284925,-274347826
1748,1972,PRK,141017872,81703952,-59313920
1749,1972,PRT,2239721069,1245497999,-994223070
1750,1972,PRY,101303631,113414874,12111243
1751,1972,PYF,67939285,3660976,-64278309
1752,1972,QAT,135733567,358959006,223225439
1753,1972,REU,167109289,45433181,-121676108
1754,1972,ROU,1143325597,1007349260,-135976337
1755,1972,RWA,16332648,21478118,5145470
1756,1972,SAU,1180519788,5418078163,4237558375
1757,1972,SDN,319226208,356566503,37340295
1758,1972,SEN,283878226,228838745,-55039481
1759,1972,SGP,3390142320,1952554653,-1437587667
1760,1972,SHN,3671885,1079945,-2591940
1761,1972,SLB,15512592,15617920,105328
1762,1972,SLE,104722123,72208983,-32513140
1763,1972,SLV,271246599,262930251,-8316348
1764,1972,SOM,97125652,24538133,-72587519
1765,1972,SPM,11359030,1283529,-10075501
1766,1972,STP,6449330,4706382,-1742948
1767,1972,SUR,115603296,170593663,54990367
1768,1972,SWE,7851688352,8345895004,494206652
1769,1972,SYC,28912123,7838055,-21074068
1770,1972,SYR,346300722,196197114,-150103608
1771,1972,TCA,448462,52742,-395720
1772,1972,TCD,44126571,29684720,-14441851
1773,1972,TGO,81707880,58299011,-23408869
1774,1972,THA,1454302166,1134493966,-319808200
1775,1972,TKL,1560,0,-1560
1776,1972,TLS,7579214,3525347,-4053867
1777,1972,TON,6751313,2138262,-4613051
1778,1972,TTO,703733924,527921574,-175812350
1779,1972,TUN,465618230,338438406,-127179824
1780,1972,TUR,1417287787,902048984,-515238803
1781,1972,TWN,3786002941,2824055779,-961947162
1782,1972,TZA,263669915,262324335,-1345580
1783,1972,UGA,70071512,190697845,120626333
1784,1972,URY,207499513,210210240,2710727
1785,1972,USA,54207080526,48225925730,-5981154796
1786,1972,VCT,4057099,459341,-3597758
1787,1972,VEN,2185464377,3099850143,914385766
1788,1972,VGB,1473795,2421845,948050
1789,1972,VIR,520827735,1065613,-519762122
1790,1972,VNM,724339620,33590168,-690749452
1791,1972,VUT,25133548,7147439,-17986109
1792,1972,WLF,1061039,16102,-1044937
1793,1972,WSM,21304029,5494409,-15809620
1794,1972,YEM,68810883,5903926,-62906957
1795,1972,ZAF,3309619022,2475307237,-834311785
1796,1972,ZMB,729231907,757749300,28517393
1797,1972,ZWE,17552676,70865068,53312392
1798,1973,AGO,515464475,758894532,243430057
1799,1973,ALB,37281776,21670511,-15611265
1800,1973,AND,120385754,2978343,-117407411
1801,1973,ANT,1664254871,1363856452,-300398419
1802,1973,ARE,702632876,1780634484,1078001608
1803,1973,ARG,2206445216,3597602980,1391157764
1804,1973,ATG,33388520,5481652,-27906868
1805,1973,AUS,6226280323,9372293079,3146012756
1806,1973,AUT,6930596764,4853038917,-2077557847
1807,1973,BDI,21445160,26753678,5308518
1808,1973,BEL,22269092332,21926670499,-342421833
1809,1973,BEN,111489084,58560726,-52928358
1810,1973,BFA,80043097,32013997,-48029100
1811,1973,BGD,697692246,270552853,-427139393
1812,1973,BGR,642348280,486984569,-155363711
1813,1973,BHR,492615177,268334880,-224280297
1814,1973,BHS,567331290,366647897,-200683393
1815,1973,BLZ,37477145,32124995,-5352150
1816,1973,BMU,167341657,34500969,-132840688
1817,1973,BOL,190717176,225033087,34315911
1818,1973,BRA,6799146013,6287366141,-511779872
1819,1973,BRB,140618844,45989377,-94629467
1820,1973,BRN,124178722,312380902,188202180
1821,1973,BTN,2767274,526473,-2240801
1822,1973,CAF,68625698,89164022,20538324
1823,1973,CAN,21757766837,25962985879,4205219042
1824,1973,CCK,1373705,44739,-1328966
1825,1973,CHE,12968656935,9106156190,-3862500745
1826,1973,CHL,1231466331,1276164070,44697739
1827,1973,CHN,3641483271,4034907779,393424508
1828,1973,CIV,699355180,998049871,298694691
1829,1973,CMR,297794971,391734964,93939993
1830,1973,COD,782801742,1214602516,431800774
1831,1973,COG,134579884,148051421,13471537
1832,1973,COK,7420385,473881,-6946504
1833,1973,COL,1059178195,1110645929,51467734
1834,1973,COM,14842147,8401592,-6440555
1835,1973,CPV,29937065,1460837,-28476228
1836,1973,CRI,437835495,419980693,-17854802
1837,1973,CUB,462179853,410563130,-51616723
1838,1973,CXR,5594739,19572195,13977456
1839,1973,CYM,5636451,1183521,-4452930
1840,1973,CYP,453631238,162117416,-291513822
1841,1973,DEU,52149872245,69512156600,17362284355
1842,1973,DJI,65033804,5907024,-59126780
1843,1973,DMA,26384886,27859557,1474671
1844,1973,DNK,7311435719,5943297781,-1368137938
1845,1973,DOM,462283487,445898415,-16385072
1846,1973,DZA,2184532850,2077869148,-106663702
1847,1973,ECU,495528563,633910199,138381636
1848,1973,EGY,1171072934,671939610,-499133324
1849,1973,ESH,9600786,6370718,-3230068
1850,1973,ESP,9237979085,5361338860,-3876640225
1851,1973,ETH,222103413,274028883,51925470
1852,1973,FIN,3696806563,3392490453,-304316110
1853,1973,FJI,193620260,75025823,-118594437
1854,1973,FLK,1241084,4803355,3562271
1855,1973,FRA,36112901458,34413817827,-1699083631
1856,1973,FRO,4362334,17537720,13175386
1857,1973,GAB,190898195,346174868,155276673
1858,1973,GBR,34893052612,28945479031,-5947573581
1859,1973,GHA,410583604,594395600,183811996
1860,1973,GIB,47733906,3074368,-44659538
1861,1973,GIN,59625766,65845778,6220012
1862,1973,GMB,27892178,26427089,-1465089
1863,1973,GNB,46264975,9806772,-36458203
1864,1973,GNQ,18255899,20801061,2545162
1865,1973,GRC,4262183148,1466715789,-2795467359
1866,1973,GRD,6090228,1068639,-5021589
1867,1973,GRL,17322422,12717189,-4605233
1868,1973,GTM,436006518,495795312,59788794
1869,1973,GUY,161976251,168401373,6425122
1870,1973,HKG,5665400932,5093847931,-571553001
1871,1973,HND,249200458,296340001,47139543
1872,1973,HTI,138891884,89271211,-49620673
1873,1973,HUN,1258726539,1228837792,-29888747
1874,1973,IDN,2793408773,3850238528,1056829755
1875,1973,IND,2681584401,2823196826,141612425
1876,1973,IOT,1410289,605153,-805136
1877,1973,IRL,2806402258,2147042097,-659360161
1878,1973,IRN,3518700251,6080613195,2561912944
1879,1973,IRQ,805175952,1776113338,970937386
1880,1973,ISL,321239894,261539287,-59700607
1881,1973,ISR,2656157072,1437701561,-1218455511
1882,1973,ITA,26569110934,20922799304,-5646311630
1883,1973,JAM,647808138,461332840,-186475298
1884,1973,JOR,285065301,62979820,-222085481
1885,1973,JPN,34976461863,36104940423,1128478560
1886,1973,KEN,465919428,381745747,-84173681
1887,1973,KHM,156798976,15667727,-141131249
1888,1973,KIR,9692576,13045802,3353226
1889,1973,KNA,63493713,15616754,-47876959
1890,1973,KOR,4227935600,3037480071,-1190455529
1891,1973,KWT,939232670,3918378767,2979146097
1892,1973,LAO,68569848,10994978,-57574870
1893,1973,LBN,1307861153,647419209,-660441944
1894,1973,LBR,2756796627,466085702,-2290710925
1895,1973,LBY,1802703938,3631468650,1828764712
1896,1973,LCA,35071696,2075139,-32996557
1897,1973,LKA,260659089,313925153,53266064
1898,1973,MAC,98671504,125164862,26493358
1899,1973,MAR,1061600334,971333605,-90266729
1900,1973,MDG,190172360,231907098,41734738
1901,1973,MDV,2674029,1319929,-1354100
1902,1973,MEX,4672359653,3196365958,-1475993695
1903,1973,MLI,86087091,31830913,-54256178
1904,1973,MLT,199635349,78640738,-120994611
1905,1973,MMR,144127897,168133580,24005683
1906,1973,MNG,2683636,5393905,2710269
1907,1973,MOZ,424751820,356199542,-68552278
1908,1973,MRT,108050001,160056750,52006749
1909,1973,MSR,24548501,9740530,-14807971
1910,1973,MUS,153415818,144322940,-9092878
1911,1973,MWI,110913281,100245544,-10667737
1912,1973,MYS,2608896658,3491368292,882471634
1913,1973,NCL,178750558,251007191,72256633
1914,1973,NER,82163798,63843967,-18319831
1915,1973,NGA,1596224728,3367495204,1771270476
1916,1973,NIC,322680612,309009138,-13671474
1917,1973,NIU,272517,10997,-261520
1918,1973,NLD,27198758735,22792659289,-4406099446
1919,1973,NOR,5920744054,6283676940,362932886
1920,1973,NPL,54590769,26224298,-28366471
1921,1973,NRU,17877180,38616334,20739154
1922,1973,NZL,2068794993,2609607259,540812266
1923,1973,OMN,134412780,318149297,183736517
1924,1973,PAK,984598262,960916021,-23682241
1925,1973,PAN,1478089796,360139741,-1117950055
1926,1973,PCN,14464,0,-14464
1927,1973,PER,1286389973,1089346544,-197043429
1928,1973,PHL,1878542113,1999595960,121053847
1929,1973,PNG,283858574,417546467,133687893
1930,1973,POL,3561209579,2389609029,-1171600550
1931,1973,PRK,299886936,133748606,-166138330
1932,1973,PRT,3121144429,1799394507,-1321749922
1933,1973,PRY,166073532,169858162,3784630
1934,1973,PYF,132729191,5254025,-127475166
1935,1973,QAT,182851790,537940446,355088656
1936,1973,REU,249178042,61238646,-187939396
1937,1973,ROU,1632410689,1421325954,-211084735
1938,1973,RWA,18636395,22220568,3584173
1939,1973,SAU,1770909612,8822837813,7051928201
1940,1973,SDN,415353795,459028057,43674262
1941,1973,SEN,377097326,226518454,-150578872
1942,1973,SGP,5306392063,3136770794,-2169621269
1943,1973,SHN,2426155,1894330,-531825
1944,1973,SLB,17918874,25442534,7523660
1945,1973,SLE,136826160,142995463,6169303
1946,1973,SLV,363867156,380388800,16521644
1947,1973,SOM,192188355,68256809,-123931546
1948,1973,SPM,15174506,2312010,-12862496
1949,1973,STP,8695262,9470607,775345
1950,1973,SUR,128323331,219177160,90853829
1951,1973,SWE,10312059383,11670984798,1358925415
1952,1973,SYC,25653591,4571723,-21081868
1953,1973,SYR,489674694,266369047,-223305647
1954,1973,TCA,765160,35950,-729210
1955,1973,TCD,74514087,40719769,-33794318
1956,1973,TGO,93535449,84057571,-9477878
1957,1973,THA,2005838737,1575309473,-430529264
1958,1973,TLS,11450350,7959147,-3491203
1959,1973,TON,10107936,3931746,-6176190
1960,1973,TTO,766995910,727424415,-39571495
1961,1973,TUN,632649082,393619595,-239029487
1962,1973,TUR,2069897877,1356674335,-713223542
1963,1973,TWN,4219075081,4365181038,146105957
1964,1973,TZA,333251389,312233857,-21017532
1965,1973,UGA,58470023,234493402,176023379
1966,1973,URY,228575244,302944328,74369084
1967,1973,USA,68237083951,68612517342,375433391
1968,1973,VCT,4801410,1373232,-3428178
1969,1973,VEN,2537579524,4253555826,1715976302
1970,1973,VGB,2186871,39033,-2147838
1971,1973,VIR,638589626,18048268,-620541358
1972,1973,VNM,717533301,80162466,-637370835
1973,1973,VUT,30595249,8018563,-22576686
1974,1973,WLF,1671159,94092,-1577067
1975,1973,WSM,23634992,5803338,-17831654
1976,1973,YEM,104884565,11202423,-93682142
1977,1973,ZAF,4561672672,3351889787,-1209782885
1978,1973,ZMB,553756716,1101765340,548008624
1979,1973,ZWE,15476882,84003550,68526668
1980,1974,AGO,654880105,1212696521,557816416
1981,1974,ALB,61340418,42237029,-19103389
1982,1974,AND,125837775,4951158,-120886617
1983,1974,ANT,3658281377,2690894024,-967387353
1984,1974,ARE,1382086594,5739108611,4357022017
1985,1974,ARG,3711193152,4353372012,642178860
1986,1974,ATG,52207640,13258424,-38949216
1987,1974,AUS,10727155583,11443428539,716272956
1988,1974,AUT,9154447862,6573380159,-2581067703
1989,1974,BDI,42703445,23264649,-19438796
1990,1974,BEL,30318806092,27429363471,-2889442621
1991,1974,BEN,150438557,71927553,-78511004
1992,1974,BFA,126100479,47344739,-78755740
1993,1974,BGD,818175414,289799962,-528375452
1994,1974,BGR,1081803379,630208842,-451594537
1995,1974,BHR,1240622835,874288621,-366334214
1996,1974,BHS,2061637944,1010088628,-1051549316
1997,1974,BLZ,53943166,50860742,-3082424
1998,1974,BMU,912980532,48952543,-864027989
1999,1974,BOL,451135618,440254336,-10881282
2000,1974,BRA,13383531538,8097532705,-5285998833
2001,1974,BRB,175189346,77469392,-97719954
2002,1974,BRN,173312554,949173448,775860894
2003,1974,BTN,8145354,1938058,-6207296
2004,1974,CAF,58456842,60484999,2028157
2005,1974,CAN,30201598549,33809640630,3608042081
2006,1974,CCK,15755447,80476240,64720793
2007,1974,CHE,16069090919,11421028905,-4648062014
2008,1974,CHL,1963087555,2395647753,432560198
2009,1974,CHN,5736296209,5232745822,-503550387
2010,1974,CIV,916607971,1376918565,460310594
2011,1974,CMR,412479472,582950559,170471087
2012,1974,COD,1149836921,1675688835,525851914
2013,1974,COG,185715573,277573508,91857935
2014,1974,COK,3023428,1023467,-1999961
2015,1974,COL,1641149058,1464584921,-176564137
2016,1974,COM,22657694,7813913,-14843781
2017,1974,CPV,47671711,2818145,-44853566
2018,1974,CRI,698103222,532862150,-165241072
2019,1974,CUB,1031305988,948408563,-82897425
2020,1974,CXR,7578563,33162566,25584003
2021,1974,CYM,9837005,620101,-9216904
2022,1974,CYP,489233223,156510850,-332722373
2023,1974,DEU,69288076919,97038357910,27750280991
2024,1974,DJI,97343555,12723833,-84619722
2025,1974,DMA,35871796,46764876,10893080
2026,1974,DNK,9513390952,7515466616,-1997924336
2027,1974,DOM,828277928,721037618,-107240310
2028,1974,DZA,3971967173,4824194517,852227344
2029,1974,ECU,960878512,1254930494,294051982
2030,1974,EGY,2588341721,988364554,-1599977167
2031,1974,ESH,9170698,29769398,20598700
2032,1974,ESP,14716050380,7048600366,-7667450014
2033,1974,ETH,376062895,424564451,48501556
2034,1974,FIN,5543501392,4841391734,-702109658
2035,1974,FJI,249775766,113022576,-136753190
2036,1974,FLK,2320628,8412240,6091612
2037,1974,FRA,52788971219,43678147488,-9110823731
2038,1974,FRO,70842306,37388622,-33453684
2039,1974,GAB,359255968,978033287,618777319
2040,1974,GBR,49099620067,37130546500,-11969073567
2041,1974,GHA,765680709,730684077,-34996632
2042,1974,GIB,113225477,5345405,-107880072
2043,1974,GIN,72588006,103698165,31110159
2044,1974,GMB,45143862,50625048,5481186
2045,1974,GNB,34435869,12896198,-21539671
2046,1974,GNQ,11988054,15363844,3375790
2047,1974,GRC,5297875542,1981486172,-3316389370
2048,1974,GRD,5835209,856319,-4978890
2049,1974,GRL,105374761,59819636,-45555125
2050,1974,GTM,707714082,675229689,-32484393
2051,1974,GUY,234996899,313531895,78534996
2052,1974,HKG,6596670710,5990296071,-606374639
2053,1974,HND,373049225,324356678,-48692547
2054,1974,HTI,201800839,145664234,-56136605
2055,1974,HUN,1982025988,1493000131,-489025857
2056,1974,IDN,4270633292,7993219174,3722585882
2057,1974,IND,3759432623,3752721520,-6711103
2058,1974,IOT,9933749,5585486,-4348263
2059,1974,IRL,4079453097,2948810291,-1130642806
2060,1974,IRN,6597295567,17503756554,10906460987
2061,1974,IRQ,2808717307,5592752806,2784035499
2062,1974,ISL,452771755,303752830,-149018925
2063,1974,ISR,3468080502,1772395099,-1695685403
2064,1974,ITA,39394617882,28203773001,-11190844881
2065,1974,JAM,909024150,737559702,-171464448
2066,1974,JOR,528089734,175016544,-353073190
2067,1974,JPN,55449069197,53782580330,-1666488867
2068,1974,KEN,765108061,505900316,-259207745
2069,1974,KHM,202998019,18716168,-184281851
2070,1974,KIR,11299863,16448388,5148525
2071,1974,KNA,53533212,27438542,-26094670
2072,1974,KOR,6864339248,4472992757,-2391346491
2073,1974,KWT,1571920032,9341191221,7769271189
2074,1974,LAO,71537948,22174142,-49363806
2075,1974,LBN,1938114282,1227116846,-710997436
2076,1974,LBR,3468721295,554734237,-2913987058
2077,1974,LBY,3146471156,7632287612,4485816456
2078,1974,LCA,42851594,2522386,-40329208
2079,1974,LKA,659650734,541215208,-118435526
2080,1974,MAC,150191906,124894191,-25297715
2081,1974,MAR,1794291224,1722393441,-71897783
2082,1974,MDG,281492283,275150797,-6341486
2083,1974,MDV,6884384,3903970,-2980414
2084,1974,MEX,7463631003,4724769773,-2738861230
2085,1974,MLI,155443879,67081852,-88362027
2086,1974,MLT,301882511,147000173,-154882338
2087,1974,MMR,221161814,270375985,49214171
2088,1974,MNG,3675514,5889211,2213697
2089,1974,MOZ,460904997,522041630,61136633
2090,1974,MRT,128204642,216922323,88717681
2091,1974,MSR,33189011,7160039,-26028972
2092,1974,MUS,288998164,291100150,2101986
2093,1974,MWI,159202968,116906552,-42296416
2094,1974,MYS,4163690120,4930816857,767126737
2095,1974,NCL,257066163,355494539,98428376
2096,1974,NER,147245859,53872362,-93373497
2097,1974,NGA,2497382273,10456577943,7959195670
2098,1974,NIC,581663802,421907867,-159755935
2099,1974,NIU,1492602,405586,-1087016
2100,1974,NLD,39566048750,31199458323,-8366590427
2101,1974,NOR,7695954745,8267615723,571660978
2102,1974,NPL,71951891,41371331,-30580560
2103,1974,NRU,17953309,72889296,54935987
2104,1974,NZL,3443209414,2562415517,-880793897
2105,1974,OMN,365084972,925177039,560092067
2106,1974,PAK,1959823386,1147673598,-812149788
2107,1974,PAN,2475367073,506570915,-1968796158
2108,1974,PCN,42712,0,-42712
2109,1974,PER,1964688311,1664984836,-299703475
2110,1974,PHL,3398980747,2838951038,-560029709
2111,1974,PNG,423370051,568706208,145336157
2112,1974,POL,5423887780,3359967031,-2063920749
2113,1974,PRK,699615519,258480332,-441135187
2114,1974,PRT,4686709654,2228361476,-2458348178
2115,1974,PRY,280956798,236799386,-44157412
2116,1974,PYF,176519906,8476854,-168043052
2117,1974,QAT,294790231,1432575229,1137784998
2118,1974,REU,288843095,61580268,-227262827
2119,1974,ROU,2445717830,2070340461,-375377369
2120,1974,RWA,30794401,38534721,7740320
2121,1974,SAU,3826008791,33145122284,29319113493
2122,1974,SDN,634655860,455354816,-179301044
2123,1974,SEN,549954205,414790133,-135164072
2124,1974,SGP,8608522904,5832028636,-2776494268
2125,1974,SHN,5197594,3667013,-1530581
2126,1974,SLB,26047600,33497936,7450336
2127,1974,SLE,198344106,134705903,-63638203
2128,1974,SLV,598493921,512685743,-85808178
2129,1974,SOM,218985708,57886017,-161099691
2130,1974,SPM,20228043,2834283,-17393760
2131,1974,STP,8491281,13665993,5174712
2132,1974,SUR,204043206,241168332,37125126
2133,1974,SWE,15417716739,15174232277,-243484462
2134,1974,SYC,25240699,20704116,-4536583
2135,1974,SYR,1300801814,793760974,-507040840
2136,1974,TCA,8688185,562325,-8125860
2137,1974,TCD,83823260,58255116,-25568144
2138,1974,TGO,126370520,216771235,90400715
2139,1974,THA,3098979214,2604347298,-494631916
2140,1974,TKL,27433,0,-27433
2141,1974,TLS,16043306,6930391,-9112915
2142,1974,TON,16666910,9697489,-6969421
2143,1974,TTO,2227164177,1860931192,-366232985
2144,1974,TUN,1076598028,981375280,-95222748
2145,1974,TUR,3955303588,1593647906,-2361655682
2146,1974,TWN,5646551082,5361582598,-284968484
2147,1974,TZA,623670570,369297651,-254372919
2148,1974,UGA,82730845,251823928,169093083
2149,1974,URY,486553694,360389722,-126163972
2150,1974,USA,99164587066,96178071945,-2986515121
2151,1974,VCT,5377562,1465497,-3912065
2152,1974,VEN,3991959735,10562470032,6570510297
2153,1974,VGB,14311046,472575,-13838471
2154,1974,VIR,153497075,7323213,-146173862
2155,1974,VNM,905718286,142837710,-762880576
2156,1974,VUT,39790478,23365037,-16425441
2157,1974,WLF,2494658,1258,-2493400
2158,1974,WSM,34625826,14906012,-19719814
2159,1974,YEM,187010591,20767660,-166242931
2160,1974,ZAF,7224509862,4378317808,-2846192054
2161,1974,ZMB,947796458,1316246527,368450069
2162,1974,ZWE,21327567,80603558,59275991
2163,1975,AGO,344685987,863226661,518540674
2164,1975,ALB,71121584,51132523,-19989061
2165,1975,AND,141246016,5454079,-135791937
2166,1975,ANT,3401031027,2399307193,-1001723834
2167,1975,ARE,2230312673,6481311087,4250998414
2168,1975,ARG,3709211939,3222025201,-487186738
2169,1975,ATG,61905573,12034599,-49870974
2170,1975,AUS,9390487407,11959865273,2569377866
2171,1975,AUT,9359654457,6695218196,-2664436261
2172,1975,BDI,39714098,45260151,5546053
2173,1975,BEL,30660811406,27880308808,-2780502598
2174,1975,BEN,177940656,45864759,-132075897
2175,1975,BFA,133275750,51757478,-81518272
2176,1975,BGD,1045958548,218316174,-827642374
2177,1975,BGR,1328449795,615439998,-713009797
2178,1975,BHR,1216784784,660282962,-556501822
2179,1975,BHS,2638119506,1025380548,-1612738958
2180,1975,BLZ,166330693,90901746,-75428947
2181,1975,BMU,730716114,46476259,-684239855
2182,1975,BOL,630192572,458469435,-171723137
2183,1975,BRA,12132756841,8732149857,-3400606984
2184,1975,BRB,179996350,90651345,-89345005
2185,1975,BRN,314519752,1143390260,828870508
2186,1975,BTN,2674865,619545,-2055320
2187,1975,CAF,56392039,60433538,4041499
2188,1975,CAN,32059649846,32986785752,927135906
2189,1975,CCK,3001315,728528,-2272787
2190,1975,CHE,14965102315,12337268221,-2627834094
2191,1975,CHL,1725923082,1695503153,-30419929
2192,1975,CHN,5736979522,5713754269,-23225253
2193,1975,CIV,1051740864,1409654421,357913557
2194,1975,CMR,520629885,492027918,-28601967
2195,1975,COD,1107943876,1053879302,-54064574
2196,1975,COG,252542569,356914508,104371939
2197,1975,COK,2122671,624586,-1498085
2198,1975,COL,1547184010,1647627898,100443888
2199,1975,COM,21989187,5787498,-16201689
2200,1975,CPV,45861579,1519826,-44341753
2201,1975,CRI,623203819,542976631,-80227188
2202,1975,CUB,1746841946,1121004388,-625837558
2203,1975,CXR,11736887,40839983,29103096
2204,1975,CYM,8892665,384771,-8507894
2205,1975,CYP,343546480,170614977,-172931503
2206,1975,DEU,74148626316,95814559854,21665933538
2207,1975,DJI,98607708,26639845,-71967863
2208,1975,DMA,36886219,43168221,6282002
2209,1975,DNK,9987732872,8336837262,-1650895610
2210,1975,DOM,924634644,953794110,29159466
2211,1975,DZA,5685036249,4680388151,-1004648098
2212,1975,ECU,1139350081,1073676329,-65673752
2213,1975,EGY,4151097387,919489685,-3231607702
2214,1975,ESH,7741962,35114483,27372521
2215,1975,ESP,15230768848,7722393487,-7508375361
2216,1975,ETH,304146105,267784152,-36361953
2217,1975,FIN,6035945186,4401350819,-1634594367
2218,1975,FJI,247234665,169960839,-77273826
2219,1975,FLK,4753739,2935802,-1817937
2220,1975,FRA,52137068905,49450513496,-2686555409
2221,1975,FRO,79688774,30872050,-48816724
2222,1975,GAB,554402296,1147539425,593137129
2223,1975,GBR,48955972511,42532552983,-6423419528
2224,1975,GHA,736709693,781075541,44365848
2225,1975,GIB,105754919,3642526,-102112393
2226,1975,GIN,131925948,119011727,-12914221
2227,1975,GMB,51191610,47938736,-3252874
2228,1975,GNB,30375018,21641447,-8733571
2229,1975,GNQ,16373563,22008310,5634747
2230,1975,GRC,5619439612,2507493021,-3111946591
2231,1975,GRD,7447813,713378,-6734435
2232,1975,GRL,134198879,62809823,-71389056
2233,1975,GTM,764796991,722404800,-42392191
2234,1975,GUY,310192509,375552501,65359992
2235,1975,HKG,6699317203,6012382060,-686935143
2236,1975,HND,367944791,304762242,-63182549
2237,1975,HTI,225243425,134660425,-90583000
2238,1975,HUN,2054941679,1457254723,-597686956
2239,1975,IDN,5506561925,7760657739,2254095814
2240,1975,IND,4729386946,4176800586,-552586360
2241,1975,IOT,5282745,1533752,-3748993
2242,1975,IRL,3940303171,3471250203,-469052968
2243,1975,IRN,12264766140,17691960798,5427194658
2244,1975,IRQ,4900232257,6914167645,2013935388
2245,1975,ISL,365102417,254699815,-110402602
2246,1975,ISR,3465181579,1961458042,-1503723537
2247,1975,ITA,36000377668,32200552240,-3799825428
2248,1975,JAM,1020926705,766927117,-253999588
2249,1975,JOR,757898073,181960868,-575937205
2250,1975,JPN,51999019701,53994821130,1995801429
2251,1975,KEN,659057830,477050341,-182007489
2252,1975,KHM,49210752,4345671,-44865081
2253,1975,KIR,14487226,24569279,10082053
2254,1975,KNA,63230478,15761240,-47469238
2255,1975,KOR,6909215813,4877604074,-2031611739
2256,1975,KWT,2210847229,9314307977,7103460748
2257,1975,LAO,38447338,10780529,-27666809
2258,1975,LBN,1715907884,1071310145,-644597739
2259,1975,LBR,4200853829,551945234,-3648908595
2260,1975,LBY,4048732186,6329327871,2280595685
2261,1975,LCA,41519056,3336793,-38182263
2262,1975,LKA,709672115,567123627,-142548488
2263,1975,MAC,100914433,154800512,53886079
2264,1975,MAR,2477550941,1560547779,-917003162
2265,1975,MDG,315664850,348796755,33131905
2266,1975,MDV,14329430,3903799,-10425631
2267,1975,MEX,7944691203,4453859026,-3490832177
2268,1975,MLI,202244841,43676075,-158568766
2269,1975,MLT,328750905,123421532,-205329373
2270,1975,MMR,227626049,247127279,19501230
2271,1975,MNG,3743474,4811803,1068329
2272,1975,MOZ,254885382,422269564,167384182
2273,1975,MRT,208702561,202386400,-6316161
2274,1975,MSR,32914057,7696107,-25217950
2275,1975,MUS,305754474,337888201,32133727
2276,1975,MWI,191448662,145198269,-46250393
2277,1975,MYS,3840632481,4419477674,578845193
2278,1975,NCL,316325344,415323884,98998540
2279,1975,NER,169351746,76150290,-93201456
2280,1975,NGA,5303033808,9217527156,3914493348
2281,1975,NIC,468525160,448881512,-19643648
2282,1975,NIU,1266842,105275,-1161567
2283,1975,NLD,39667384685,34491929826,-5175454859
2284,1975,NOR,8956649914,9288504055,331854141
2285,1975,NPL,104616923,47236682,-57380241
2286,1975,NRU,20134278,83396709,63262431
2287,1975,NZL,2990883609,2274791586,-716092023
2288,1975,OMN,795749841,1187565209,391815368
2289,1975,PAK,2248046151,1140202541,-1107843610
2290,1975,PAN,2645397088,594232564,-2051164524
2291,1975,PCN,40315,3940,-36375
2292,1975,PER,2654601281,1376616936,-1277984345
2293,1975,PHL,3708511812,2750991065,-957520747
2294,1975,PNG,449701356,419890919,-29810437
2295,1975,POL,6348604065,3858592160,-2490011905
2296,1975,PRK,480109041,334787705,-145321336
2297,1975,PRT,3730603028,2001885627,-1728717401
2298,1975,PRY,299615551,230388971,-69226580
2299,1975,PYF,176358535,7194481,-169164054
2300,1975,QAT,528374601,1258135292,729760691
2301,1975,REU,344758540,76968032,-267790508
2302,1975,ROU,2667042891,2461674034,-205368857
2303,1975,RWA,43149316,47315663,4166347
2304,1975,SAU,6496305149,31312509018,24816203869
2305,1975,SDN,972146940,459889819,-512257121
2306,1975,SEN,585020381,478100843,-106919538
2307,1975,SGP,8447499494,5537656518,-2909842976
2308,1975,SHN,5436452,1412408,-4024044
2309,1975,SLB,30095661,17360348,-12735313
2310,1975,SLE,171586773,162113718,-9473055
2311,1975,SLV,608346700,589012888,-19333812
2312,1975,SOM,184445598,90706678,-93738920
2313,1975,SPM,22661588,2228550,-20433038
2314,1975,STP,7866256,7281103,-585153
2315,1975,SUR,265305183,284684094,19378911
2316,1975,SWE,16846747260,16453333880,-393413380
2317,1975,SYC,28035452,12154975,-15880477
2318,1975,SYR,1701725283,1200270236,-501455047
2319,1975,TCA,5105673,651298,-4454375
2320,1975,TCD,91546939,41979682,-49567257
2321,1975,TGO,208663843,157746960,-50916883
2322,1975,THA,3192896656,2431993362,-760903294
2323,1975,TKL,11194,0,-11194
2324,1975,TLS,10008583,6065487,-3943096
2325,1975,TON,17760603,7286322,-10474281
2326,1975,TTO,1915789452,1612171196,-303618256
2327,1975,TUN,1330941202,885967592,-444973610
2328,1975,TUR,4617400349,1567922168,-3049478181
2329,1975,TWN,5915031470,5303115780,-611915690
2330,1975,TZA,490093857,321704174,-168389683
2331,1975,UGA,76399120,229922455,153523335
2332,1975,URY,535407274,387876073,-147531201
2333,1975,USA,93794316951,1.03E+11,9173779536
2334,1975,VCT,7060361,1412820,-5647541
2335,1975,VEN,5143192932,8750242924,3607049992
2336,1975,VGB,9547400,454416,-9092984
2337,1975,VIR,56262909,13125379,-43137530
2338,1975,VNM,470749158,100795376,-369953782
2339,1975,VUT,33196794,11955222,-21241572
2340,1975,WLF,1011429,10875,-1000554
2341,1975,WSM,31435994,7736805,-23699189
2342,1975,YEM,307650074,10601129,-297048945
2343,1975,ZAF,7474788186,5011985702,-2462802484
2344,1975,ZMB,933785492,810537743,-123247749
2345,1975,ZWE,20611477,116956473,96344996
2346,1976,AGO,233514439,537341698,303827259
2347,1976,ALB,47163132,55665549,8502417
2348,1976,AND,175131180,6648173,-168483007
2349,1976,ANT,5086963385,2549584934,-2537378451
2350,1976,ARE,3106058179,8623768329,5517710150
2351,1976,ARG,3009984330,4132615565,1122631235
2352,1976,ATG,14231767,1953181,-12278586
2353,1976,AUS,10987288997,13646075790,2658786793
2354,1976,AUT,11147453994,7562150361,-3585303633
2355,1976,BDI,48932467,48966063,33596
2356,1976,BEL,36005201008,31908850196,-4096350812
2357,1976,BEN,209480090,43419310,-166060780
2358,1976,BFA,144044456,53920884,-90123572
2359,1976,BGD,567177705,345007569,-222170136
2360,1976,BGR,1183762259,761596613,-422165646
2361,1976,BHR,1758718343,910784388,-847933955
2362,1976,BHS,3077769009,938610203,-2139158806
2363,1976,BLZ,150308390,34676693,-115631697
2364,1976,BMU,1066797121,68618755,-998178366
2365,1976,BOL,577038018,511320612,-65717406
2366,1976,BRA,12779881092,9513432951,-3266448141
2367,1976,BRB,192711759,70681851,-122029908
2368,1976,BRN,260130743,1414371195,1154240452
2369,1976,BTN,3671911,451980,-3219931
2370,1976,CAF,49891021,67921063,18030042
2371,1976,CAN,35273723947,38006989456,2733265509
2372,1976,CCK,4102647,1234903,-2867744
2373,1976,CHE,14321482465,14079361174,-242121291
2374,1976,CHL,1619275650,2236859554,617583904
2375,1976,CHN,4434887996,6064292084,1629404088
2376,1976,CIV,1209153999,1665479357,456325358
2377,1976,CMR,561819345,497413782,-64405563
2378,1976,COD,932648738,1353312024,420663286
2379,1976,COG,318789918,290439634,-28350284
2380,1976,COK,5041308,704254,-4337054
2381,1976,COL,1766548382,1972595925,206047543
2382,1976,COM,15676414,21299095,5622681
2383,1976,CPV,44711099,1894102,-42816997
2384,1976,CRI,755039516,639117513,-115922003
2385,1976,CUB,1436167909,593248120,-842919789
2386,1976,CXR,8198731,28364461,20165730
2387,1976,CYM,22834572,1725755,-21108817
2388,1976,CYP,441644476,249346264,-192298212
2389,1976,DEU,89790086339,1.08E+11,18045289355
2390,1976,DJI,98621394,27712297,-70909097
2391,1976,DMA,28719088,40482654,11763566
2392,1976,DNK,11920179919,8646827413,-3273352506
2393,1976,DOM,890189707,705784544,-184405163
2394,1976,DZA,4928539370,4734680661,-193858709
2395,1976,ECU,1142538020,1373338435,230800415
2396,1976,EGY,4271282746,1471543248,-2799739498
2397,1976,ESH,3992926,10994895,7001969
2398,1976,ESP,16329428544,8939354567,-7390073977
2399,1976,ETH,362906245,287323353,-75582892
2400,1976,FIN,5696308852,5149603580,-546705272
2401,1976,FJI,251103803,100390433,-150713370
2402,1976,FLK,4255456,4255088,-368
2403,1976,FRA,62678504418,52689079174,-9989425244
2404,1976,FRO,120313045,57393615,-62919430
2405,1976,GAB,638145573,1120133789,481988216
2406,1976,GBR,52153203712,43934789819,-8218413893
2407,1976,GHA,856539446,787199831,-69339615
2408,1976,GIB,109165935,7582764,-101583171
2409,1976,GIN,101051716,211487887,110436171
2410,1976,GMB,68706787,40614186,-28092601
2411,1976,GNB,33667946,9761326,-23906620
2412,1976,GNQ,8581226,12137528,3556302
2413,1976,GRC,5779129217,2466078015,-3313051202
2414,1976,GRD,13961659,13599618,-362041
2415,1976,GRL,137249951,76545065,-60704886
2416,1976,GTM,961975059,901476778,-60498281
2417,1976,GUY,327990942,308585822,-19405120
2418,1976,HKG,8735788669,8009264894,-726523775
2419,1976,HND,411269505,417210590,5941085
2420,1976,HTI,257809129,193774201,-64034928
2421,1976,HUN,2017062106,1326820354,-690241752
2422,1976,IDN,6028743547,9505940862,3477197315
2423,1976,IND,4497540542,5437495308,939954766
2424,1976,IOT,780763,5144133,4363370
2425,1976,IRL,4210838598,3398299772,-812538826
2426,1976,IRN,12761246195,20922503421,8161257226
2427,1976,IRQ,4501751587,7944807168,3443055581
2428,1976,ISL,358305879,367935674,9629795
2429,1976,ISR,4047510659,2287848623,-1759662036
2430,1976,ITA,40931923209,34293958022,-6637965187
2431,1976,JAM,804625113,644906702,-159718411
2432,1976,JOR,1266707747,336777781,-929929966
2433,1976,JPN,58685142498,64596483874,5911341376
2434,1976,KEN,933468622,842076184,-91392438
2435,1976,KHM,4003411,2873165,-1130246
2436,1976,KIR,19061406,18276550,-784856
2437,1976,KNA,58656872,21085222,-37571650
2438,1976,KOR,8283670761,7562681701,-720989060
2439,1976,KWT,3394789803,9460319850,6065530047
2440,1976,LAO,34150673,10899680,-23250993
2441,1976,LBN,453860718,462744705,8883987
2442,1976,LBR,4449958698,639034157,-3810924541
2443,1976,LBY,4028467648,10386381667,6357914019
2444,1976,LCA,45438048,5161638,-40276410
2445,1976,LKA,592551048,554602539,-37948509
2446,1976,MAC,129690759,228739004,99048245
2447,1976,MAR,2624912116,1218575713,-1406336403
2448,1976,MDG,263132465,315232204,52099739
2449,1976,MDV,6536408,4759047,-1777361
2450,1976,MEX,7631473633,5068374476,-2563099157
2451,1976,MLI,165665243,61546907,-104118336
2452,1976,MLT,380806254,185518419,-195287835
2453,1976,MMR,221387470,293231876,71844406
2454,1976,MNG,7069095,8743657,1674562
2455,1976,MOZ,237559743,312637453,75077710
2456,1976,MRT,188182709,196525640,8342931
2457,1976,MSR,51606840,10840461,-40766379
2458,1976,MUS,334961070,244617455,-90343615
2459,1976,MWI,162385132,140064689,-22320443
2460,1976,MYS,4240898778,6192801299,1951902521
2461,1976,NCL,258123507,372787167,114663660
2462,1976,NER,163956742,91973950,-71982792
2463,1976,NGA,6583541029,12386802570,5803261541
2464,1976,NIC,533349647,563823517,30473870
2465,1976,NIU,429895,90098,-339797
2466,1976,NLD,45003419705,38326429143,-6676990562
2467,1976,NOR,10443542880,7557494598,-2886048282
2468,1976,NPL,81136514,68144158,-12992356
2469,1976,NRU,28695658,47224158,18528500
2470,1976,NZL,2959044955,2825148027,-133896928
2471,1976,OMN,796337164,1563891741,767554577
2472,1976,PAK,2194051216,1241552995,-952498221
2473,1976,PAN,2947863467,661590132,-2286273335
2474,1976,PCN,28722,1426,-27296
2475,1976,PER,1899658687,1326756212,-572902475
2476,1976,PHL,3964416092,2761676938,-1202739154
2477,1976,PNG,430431895,648898417,218466522
2478,1976,POL,6574521003,4474311129,-2100209874
2479,1976,PRK,303356489,233286496,-70069993
2480,1976,PRT,4181118614,1798903786,-2382214828
2481,1976,PRY,342435789,239271052,-103164737
2482,1976,PYF,186123003,7223755,-178899248
2483,1976,QAT,859613936,1992881754,1133267818
2484,1976,REU,381127118,102609878,-278517240
2485,1976,ROU,2759472947,2865649256,106176309
2486,1976,RWA,63914386,87831357,23916971
2487,1976,SAU,9571881084,36333446369,26761565285
2488,1976,SDN,893755290,608247867,-285507423
2489,1976,SEN,590264181,473954052,-116310129
2490,1976,SGP,9457942469,6676405202,-2781537267
2491,1976,SHN,4952690,497694,-4454996
2492,1976,SLB,27437813,27325670,-112143
2493,1976,SLE,154128663,161956824,7828161
2494,1976,SLV,734816430,814089930,79273500
2495,1976,SOM,147276801,78389130,-68887671
2496,1976,SPM,21397225,3148710,-18248515
2497,1976,STP,7627825,5537783,-2090042
2498,1976,SUR,267728841,290294748,22565907
2499,1976,SWE,17893626726,17701505875,-192120851
2500,1976,SYC,35605218,3393038,-32212180
2501,1976,SYR,2469226922,1597480177,-871746745
2502,1976,TCA,5915390,1887031,-4028359
2503,1976,TCD,73279290,83175391,9896101
2504,1976,TGO,196871976,109874831,-86997145
2505,1976,THA,3367984987,3057845361,-310139626
2506,1976,TKL,32970,0,-32970
2507,1976,TLS,9338297,2381115,-6957182
2508,1976,TON,15776071,5899778,-9876293
2509,1976,TTO,2440034427,2044402704,-395631723
2510,1976,TUN,1414033779,825245287,-588788492
2511,1976,TUR,5298014079,2039593179,-3258420900
2512,1976,TUV,181482,0,-181482
2513,1976,TWN,6760036997,7504022600,743985603
2514,1976,TZA,663716735,540711717,-123005018
2515,1976,UGA,154055385,334066315,180010930
2516,1976,URY,693302268,592420036,-100882232
2517,1976,USA,1.14E+11,1.11E+11,-3031185807
2518,1976,VCT,23194571,1646570,-21548001
2519,1976,VEN,6413269572,9192478555,2779208983
2520,1976,VGB,6288394,1361790,-4926604
2521,1976,VIR,44277101,14156453,-30120648
2522,1976,VNM,470423688,120995361,-349428327
2523,1976,VUT,24390908,13969226,-10421682
2524,1976,WLF,966177,77734,-888443
2525,1976,WSM,29685475,7874168,-21811307
2526,1976,YEM,483222190,33626269,-449595921
2527,1976,ZAF,6434322481,5872445137,-561877344
2528,1976,ZMB,603338924,976397818,373058894
2529,1976,ZWE,11644506,96703898,85059392
2530,1977,AGO,557518612,438450247,-119068365
2531,1977,ALB,70893627,66763121,-4130506
2532,1977,AND,236501855,6446851,-230055004
2533,1977,ANT,4164580073,2522825931,-1641754142
2534,1977,ARE,4045812832,8973498850,4927686018
2535,1977,ARG,4052729951,6250927728,2198197777
2536,1977,ATG,43253308,2751882,-40501426
2537,1977,AUS,11821818194,13773354442,1951536248
2538,1977,AUT,13760615286,8764940710,-4995674576
2539,1977,BDI,56554145,72877367,16323222
2540,1977,BEL,40962286564,36541772587,-4420513977
2541,1977,BEN,290447350,44323906,-246123444
2542,1977,BFA,191325506,63113395,-128212111
2543,1977,BGD,903642867,426630959,-477011908
2544,1977,BGR,1156233097,845575376,-310657721
2545,1977,BHR,1957618630,1079107010,-878511620
2546,1977,BHS,1969356141,1529248551,-440107590
2547,1977,BLZ,73464419,48541870,-24922549
2548,1977,BMU,1856086091,63617912,-1792468179
2549,1977,BOL,602019658,567815230,-34204428
2550,1977,BRA,12473239613,12282796266,-190443347
2551,1977,BRB,263508277,78246986,-185261291
2552,1977,BRN,303108919,1619892415,1316783496
2553,1977,BTN,6993651,770578,-6223073
2554,1977,CAF,84163857,104770854,20606997
2555,1977,CAN,37170616054,42144266486,4973650432
2556,1977,CCK,3612931,1460366,-2152565
2557,1977,CHE,17649211089,16748958546,-900252543
2558,1977,CHL,2235611509,2324535264,88923755
2559,1977,CHN,5311783891,6644878483,1333094592
2560,1977,CIV,1690672221,2237051147,546378926
2561,1977,CMR,714636268,667257929,-47378339
2562,1977,COD,920509304,1629212733,708703429
2563,1977,COG,205219985,208896686,3676701
2564,1977,COK,3291220,929861,-2361359
2565,1977,COL,2286689003,2604225075,317536072
2566,1977,COM,22364907,9051439,-13313468
2567,1977,CPV,51429464,3017035,-48412429
2568,1977,CRI,962165785,905151773,-57014012
2569,1977,CUB,1425427405,589822251,-835605154
2570,1977,CXR,11572898,23032851,11459953
2571,1977,CYM,52643178,3218781,-49424397
2572,1977,CYP,605615997,314995703,-290620294
2573,1977,DEU,94911276023,1.23E+11,28206933918
2574,1977,DJI,94409883,17077791,-77332092
2575,1977,DMA,46658740,44449369,-2209371
2576,1977,DNK,12648596194,9627824637,-3020771557
2577,1977,DOM,949278399,777614900,-171663499
2578,1977,DZA,6893262760,5712900256,-1180362504
2579,1977,ECU,1594042944,1450162679,-143880265
2580,1977,EGY,4808985285,1546980664,-3262004621
2581,1977,ESH,3907397,1671809,-2235588
2582,1977,ESP,17291613777,10730015202,-6561598575
2583,1977,ETH,398387733,300914492,-97473241
2584,1977,FIN,5946802402,6265815893,319013491
2585,1977,FJI,268654389,157675159,-110979230
2586,1977,FLK,3750101,4624647,874546
2587,1977,FRA,69700997514,60003974040,-9697023474
2588,1977,FRO,144880226,94474036,-50406190
2589,1977,GAB,597205270,1206660384,609455114
2590,1977,GBR,58389197013,54586157135,-3803039878
2591,1977,GHA,1143948079,1112378485,-31569594
2592,1977,GIB,166380374,11759078,-154621296
2593,1977,GIN,148040574,266827977,118787403
2594,1977,GMB,84210367,45840259,-38370108
2595,1977,GNB,41935750,15190221,-26745529
2596,1977,GNQ,4764170,15461776,10697606
2597,1977,GRC,6711588755,2788670609,-3922918146
2598,1977,GRD,29028674,17113964,-11914710
2599,1977,GRL,142867600,100155962,-42711638
2600,1977,GTM,1183734864,1290532752,106797888
2601,1977,GUY,268797697,290130032,21332335
2602,1977,HKG,10170845663,9031147965,-1139697698
2603,1977,HND,553260864,540081188,-13179676
2604,1977,HTI,333823696,234778544,-99045152
2605,1977,HUN,2627975425,1714844035,-913131390
2606,1977,IDN,6295617743,11879866280,5584248537
2607,1977,IND,4951050291,5865320358,914270067
2608,1977,IOT,2770852,642980,-2127872
2609,1977,IRL,5431656418,4450196482,-981459936
2610,1977,IRN,14250048550,19966027270,5715978720
2611,1977,IRQ,4258572537,9466222665,5207650128
2612,1977,ISL,514504305,441075095,-73429210
2613,1977,ISR,4550440983,2653831405,-1896609578
2614,1977,ITA,43496978384,41988764412,-1508213972
2615,1977,JAM,750086017,733484136,-16601881
2616,1977,JOR,1366950819,301729286,-1065221533
2617,1977,JPN,64032984856,78067134939,14034150083
2618,1977,KEN,1216130875,1325860249,109729374
2619,1977,KHM,25011780,5777136,-19234644
2620,1977,KIR,13690755,19048564,5357809
2621,1977,KNA,91581986,12042550,-79539436
2622,1977,KOR,10715805570,9691642240,-1024163330
2623,1977,KWT,4394749152,9731963776,5337214624
2624,1977,LAO,48538671,12290291,-36248380
2625,1977,LBN,1634482682,616652245,-1017830437
2626,1977,LBR,4319902302,616985262,-3702917040
2627,1977,LBY,4542719829,9727701353,5184981524
2628,1977,LCA,55211038,7253146,-47957892
2629,1977,LKA,757356359,759724085,2367726
2630,1977,MAC,172970518,278897017,105926499
2631,1977,MAR,3155016014,1325057940,-1829958074
2632,1977,MDG,300605581,328318138,27712557
2633,1977,MDV,7801926,5911660,-1890266
2634,1977,MEX,7271895999,6466533856,-805362143
2635,1977,MLI,177664704,123060250,-54604454
2636,1977,MLT,463901095,244119315,-219781780
2637,1977,MMR,317628556,263095536,-54533020
2638,1977,MNG,7821553,22122572,14301019
2639,1977,MOZ,306417403,314090233,7672830
2640,1977,MRT,250752082,200330069,-50422013
2641,1977,MSR,43793521,14346260,-29447261
2642,1977,MUS,392798798,271249532,-121549266
2643,1977,MWI,191681005,196275595,4594590
2644,1977,MYS,4879318461,7333082463,2453764002
2645,1977,NCL,305252259,396495270,91243011
2646,1977,NER,216568863,125820606,-90748257
2647,1977,NGA,9435697834,12863379072,3427681238
2648,1977,NIC,754432990,717449372,-36983618
2649,1977,NIU,547821,104187,-443634
2650,1977,NLD,52001205946,42167806107,-9833399839
2651,1977,NOR,12336025753,8461175331,-3874850422
2652,1977,NPL,101952459,54121640,-47830819
2653,1977,NRU,29618811,51382944,21764133
2654,1977,NZL,3082357386,3251411249,169053863
2655,1977,OMN,947026781,1619732819,672706038
2656,1977,PAK,2604169191,1217050321,-1387118870
2657,1977,PAN,2833153701,775222150,-2057931551
2658,1977,PCN,40277,1904,-38373
2659,1977,PER,1627242275,1649927451,22685176
2660,1977,PHL,4224280588,3136375349,-1087905239
2661,1977,PNG,511377423,762629308,251251885
2662,1977,POL,6173937505,4919577243,-1254360262
2663,1977,PRK,265135793,365015301,99879508
2664,1977,PRT,4881484502,2016419280,-2865065222
2665,1977,PRY,647919763,374872079,-273047684
2666,1977,PYF,207225420,7010246,-200215174
2667,1977,QAT,1099080452,1817424966,718344514
2668,1977,REU,417791671,119370142,-298421529
2669,1977,ROU,3016978563,3185210326,168231763
2670,1977,RWA,73940073,93360809,19420736
2671,1977,SAU,14733560794,40488775726,25755214932
2672,1977,SDN,1066479772,546108244,-520371528
2673,1977,SEN,702341379,607703772,-94637607
2674,1977,SGP,11130400383,7220792945,-3909607438
2675,1977,SHN,9040019,765784,-8274235
2676,1977,SLB,32259519,44693898,12434379
2677,1977,SLE,133945747,177998633,44052886
2678,1977,SLV,958413997,1159359863,200945866
2679,1977,SOM,222575604,67205625,-155369979
2680,1977,SPM,20088548,4924000,-15164548
2681,1977,STP,11972548,12854055,881507
2682,1977,SUR,401694159,328504053,-73190106
2683,1977,SWE,18768289052,18306733216,-461555836
2684,1977,SYC,33601205,6263285,-27337920
2685,1977,SYR,2511797478,1365234833,-1146562645
2686,1977,TCA,3889628,2517524,-1372104
2687,1977,TCD,90739939,91012502,272563
2688,1977,TGO,282351569,151990267,-130361302
2689,1977,THA,4423244278,3626984753,-796259525
2690,1977,TKL,10752,9456,-1296
2691,1977,TLS,4327210,602624,-3724586
2692,1977,TON,21742839,9762577,-11980262
2693,1977,TTO,2277946077,2101463659,-176482418
2694,1977,TUN,1694796248,900836533,-793959715
2695,1977,TUR,5280141898,1863879081,-3416262817
2696,1977,TUV,520531,0,-520531
2697,1977,TWN,7701781850,9282835537,1581053687
2698,1977,TZA,730734447,595042384,-135692063
2699,1977,UGA,310349478,518310491,207961013
2700,1977,URY,817554367,625212402,-192341965
2701,1977,USA,1.43E+11,1.19E+11,-24322423004
2702,1977,VCT,7658934,2291455,-5367479
2703,1977,VEN,9101358551,9339345611,237987060
2704,1977,VGB,6167062,776352,-5390710
2705,1977,VIR,300974827,6198817,-294776010
2706,1977,VNM,703041678,138458831,-564582847
2707,1977,VUT,28676354,23168105,-5508249
2708,1977,WLF,1235271,29952,-1205319
2709,1977,WSM,41233069,15931137,-25301932
2710,1977,YEM,617035185,16513512,-600521673
2711,1977,ZAF,5544716373,7890509255,2345792882
2712,1977,ZMB,784219166,960289823,176070657
2713,1977,ZWE,9563243,97100337,87537094
2714,1978,AGO,539521351,479049425,-60471926
2715,1978,ALB,76640051,58756555,-17883496
2716,1978,AND,245584024,6971118,-238612906
2717,1978,ANT,4374881241,1943060302,-2431820939
2718,1978,ARE,4925747158,10193643135,5267895977
2719,1978,ARG,4165327490,6562548921,2397221431
2720,1978,ATG,50684047,5240302,-45443745
2721,1978,AUS,13630177352,15000231287,1370053935
2722,1978,AUT,14960147455,11087818441,-3872329014
2723,1978,BDI,73764833,73741919,-22914
2724,1978,BEL,48136178297,43687912582,-4448265715
2725,1978,BEN,274026717,51877506,-222149211
2726,1978,BFA,203624014,38745079,-164878935
2727,1978,BGD,1376006623,591869035,-784137588
2728,1978,BGR,1302057556,830035143,-472022413
2729,1978,BHR,1999096815,1095327468,-903769347
2730,1978,BHS,888677481,1450543994,561866513
2731,1978,BLZ,107948468,73135168,-34813300
2732,1978,BMU,882159397,75742220,-806417177
2733,1978,BOL,758543546,519771855,-238771691
2734,1978,BRA,14119423685,12369118094,-1750305591
2735,1978,BRB,258790911,100746111,-158044800
2736,1978,BRN,352674877,1655212089,1302537212
2737,1978,BTN,14242861,1208484,-13034377
2738,1978,CAF,70704607,98907037,28202430
2739,1978,CAN,40424932399,47991748009,7566815610
2740,1978,CCK,7011280,2617806,-4393474
2741,1978,CHE,24737305055,22958863233,-1778441822
2742,1978,CHL,2670723160,2630553093,-40170067
2743,1978,CHN,8350959108,8478898146,127939038
2744,1978,CIV,2081801703,2763543994,681742291
2745,1978,CMR,934740960,916546323,-18194637
2746,1978,COD,889464739,1635528170,746063431
2747,1978,COG,238016367,306694747,68678380
2748,1978,COK,4095996,1110073,-2985923
2749,1978,COL,2870582259,3153905237,283322978
2750,1978,COM,22555826,17044568,-5511258
2751,1978,CPV,52187058,4716344,-47470714
2752,1978,CRI,1101675532,936213156,-165462376
2753,1978,CUB,1088473919,635305798,-453168121
2754,1978,CXR,17518599,26060971,8542372
2755,1978,CYM,54578451,5130623,-49447828
2756,1978,CYP,801885719,478650897,-323234822
2757,1978,DEU,1.11E+11,1.33E+11,22192833435
2758,1978,DJI,123566430,50217314,-73349116
2759,1978,DMA,52468707,64585494,12116787
2760,1978,DNK,13973877312,11699931647,-2273945665
2761,1978,DOM,987079533,770718165,-216361368
2762,1978,DZA,7796539843,6689700269,-1106839574
2763,1978,ECU,1587138776,1728095957,140957181
2764,1978,EGY,5786733595,2141537299,-3645196296
2765,1978,ESH,4606977,4938379,331402
2766,1978,ESP,17612222482,13036833522,-4575388960
2767,1978,ETH,460601568,281190569,-179410999
2768,1978,FIN,5990691785,7493815701,1503123916
2769,1978,FJI,336938969,181665760,-155273209
2770,1978,FLK,3231535,5710129,2478594
2771,1978,FRA,80282664179,73772351319,-6510312860
2772,1978,FRO,168936712,111566258,-57370454
2773,1978,GAB,497435168,1247756262,750321094
2774,1978,GBR,68578457653,69985876965,1407419312
2775,1978,GHA,1093813528,1087551436,-6262092
2776,1978,GIB,175141692,14650123,-160491569
2777,1978,GIN,216441664,274316877,57875213
2778,1978,GMB,100953028,36680364,-64272664
2779,1978,GNB,61384984,10060994,-51323990
2780,1978,GNQ,11293580,10560228,-733352
2781,1978,GRC,7951628193,3605938827,-4345689366
2782,1978,GRD,32267011,20443599,-11823412
2783,1978,GRL,157656329,88670667,-68985662
2784,1978,GTM,1274719303,1243584635,-31134668
2785,1978,GUY,248594695,342034572,93439877
2786,1978,HKG,13466190020,11693526616,-1772663404
2787,1978,HND,666461026,678652821,12191795
2788,1978,HTI,345556365,268704663,-76851702
2789,1978,HUN,4078983628,2440134969,-1638848659
2790,1978,IDN,6687182182,12978472642,6291290460
2791,1978,IND,7076602925,6299828657,-776774268
2792,1978,IOT,373317,224819,-148498
2793,1978,IRL,7242701298,5957236482,-1285464816
2794,1978,IRN,15856934184,20483634333,4626700149
2795,1978,IRQ,4881124365,11008442556,6127318191
2796,1978,ISL,604147180,541617194,-62529986
2797,1978,ISR,4677425429,3403529133,-1273896296
2798,1978,ITA,51662483709,53061439397,1398955688
2799,1978,JAM,789294145,846292642,56998497
2800,1978,JOR,1439662647,315052465,-1124610182
2801,1978,JPN,71676035200,95220379335,23544344135
2802,1978,KEN,1566098180,1084237062,-481861118
2803,1978,KHM,13568925,3734258,-9834667
2804,1978,KIR,20122290,18102304,-2019986
2805,1978,KNA,103399345,29853410,-73545935
2806,1978,KOR,14952657105,12298836233,-2653820872
2807,1978,KWT,4629357739,9861269095,5231911356
2808,1978,LAO,56862996,11443354,-45419642
2809,1978,LBN,1572464021,737336470,-835127551
2810,1978,LBR,3068599818,928508689,-2140091129
2811,1978,LBY,5351143187,9472630069,4121486882
2812,1978,LCA,76785629,8980323,-67805306
2813,1978,LKA,1050981059,854650367,-196330692
2814,1978,MAC,241599897,300203177,58603280
2815,1978,MAR,3154803823,1664118152,-1490685671
2816,1978,MDG,377251767,422346946,45095179
2817,1978,MDV,10950910,6688732,-4262178
2818,1978,MEX,10138114939,8392018539,-1746096400
2819,1978,MLI,228138187,109735210,-118402977
2820,1978,MLT,532529804,310787242,-221742562
2821,1978,MMR,487494754,312196965,-175297789
2822,1978,MNG,8875911,26229820,17353909
2823,1978,MOZ,335579626,311954691,-23624935
2824,1978,MRT,197351460,144049568,-53301892
2825,1978,MSR,55343901,13896119,-41447782
2826,1978,MUS,443534536,343809322,-99725214
2827,1978,MWI,277070004,199888265,-77181739
2828,1978,MYS,5339392134,8214925042,2875532908
2829,1978,NCL,304295043,251725893,-52569150
2830,1978,NER,334382090,146007101,-188374989
2831,1978,NGA,10233645042,10610765983,377120941
2832,1978,NIC,646149659,766537341,120387682
2833,1978,NIU,1117528,249317,-868211
2834,1978,NLD,55917633324,48088612044,-7829021280
2835,1978,NOR,10868285295,11036130347,167845052
2836,1978,NPL,148475764,73671187,-74804577
2837,1978,NRU,14751037,85226286,70475249
2838,1978,NZL,3254362608,3897037748,642675140
2839,1978,OMN,1010556073,1662572762,652016689
2840,1978,PAK,3120630247,1444661277,-1675968970
2841,1978,PAN,3420603872,1008971614,-2411632258
2842,1978,PCN,325941,6889,-319052
2843,1978,PER,1322434931,1842582136,520147205
2844,1978,PHL,5328156542,3927032820,-1401123722
2845,1978,PNG,632186093,696785575,64599482
2846,1978,POL,6465360739,5153370868,-1311989871
2847,1978,PRK,382229092,579311354,197082262
2848,1978,PRT,4901244583,2361235186,-2540009397
2849,1978,PRY,665616551,437514877,-228101674
2850,1978,PYF,263673918,11498104,-252175814
2851,1978,QAT,1073107805,2273571195,1200463390
2852,1978,REU,497621399,118093052,-379528347
2853,1978,ROU,3809724160,3522859184,-286864976
2854,1978,RWA,112014341,107494824,-4519517
2855,1978,SAU,20259829351,38743524489,18483695138
2856,1978,SDN,1187520976,633209993,-554310983
2857,1978,SEN,790926805,431975027,-358951778
2858,1978,SGP,13305921603,7805674920,-5500246683
2859,1978,SHN,16851645,616851,-16234794
2860,1978,SLB,40250730,46224762,5974032
2861,1978,SLE,218618222,155969198,-62649024
2862,1978,SLV,1043170374,907696536,-135473838
2863,1978,SOM,295541486,114133388,-181408098
2864,1978,SPM,21413701,4134150,-17279551
2865,1978,STP,19405302,19932264,526962
2866,1978,SUR,327673341,407718622,80045281
2867,1978,SWE,19152787307,20955734050,1802946743
2868,1978,SYC,49818450,4394304,-45424146
2869,1978,SYR,2427669797,1046319104,-1381350693
2870,1978,TCA,55356879,4330635,-51026244
2871,1978,TCD,118044205,58990306,-59053899
2872,1978,TGO,493048815,231063970,-261984845
2873,1978,THA,5021442246,4410234630,-611207616
2874,1978,TKL,0,408877,408877
2875,1978,TLS,6964550,8921465,1956915
2876,1978,TON,28094314,6987865,-21106449
2877,1978,TTO,1850123340,1970282843,120159503
2878,1978,TUN,1969919359,1070505040,-899414319
2879,1978,TUR,4404666266,2212889964,-2191776302
2880,1978,TUV,1562413,25096,-1537317
2881,1978,TWN,10228935394,12910625403,2681690009
2882,1978,TZA,1076772605,515779241,-560993364
2883,1978,UGA,288200016,375881312,87681296
2884,1978,URY,845290331,681687935,-163602396
2885,1978,USA,1.74E+11,1.41E+11,-33606449915
2886,1978,VCT,7730914,5637758,-2093156
2887,1978,VEN,9531605053,9149372410,-382232643
2888,1978,VGB,4330840,147844,-4182996
2889,1978,VIR,680762193,1883578,-678878615
2890,1978,VNM,827429279,118338482,-709090797
2891,1978,VUT,59636763,20122056,-39514707
2892,1978,WLF,2296991,34161,-2262830
2893,1978,WSM,51185506,12761628,-38423878
2894,1978,YEM,1099671673,28977174,-1070694499
2895,1978,ZAF,7167562019,8541486206,1373924187
2896,1978,ZMB,606060727,846200427,240139700
2897,1978,ZWE,22037751,52498609,30460858
2898,1979,AGO,790942076,629505593,-161436483
2899,1979,ALB,100883161,135471989,34588828
2900,1979,AND,407482894,12691785,-394791109
2901,1979,ANT,5781958166,3635341485,-2146616681
2902,1979,ARE,6274076933,12929404861,6655327928
2903,1979,ARG,8093525771,7911311003,-182214768
2904,1979,ATG,20470055,9254768,-11215287
2905,1979,AUS,16165669626,19343825032,3178155406
2906,1979,AUT,18373135022,13840680867,-4532454155
2907,1979,BDI,94173309,92749502,-1423807
2908,1979,BEL,61133817707,54915303059,-6218514648
2909,1979,BEN,473776841,57082212,-416694629
2910,1979,BFA,243422028,82264133,-161157895
2911,1979,BGD,1788583700,664819178,-1123764522
2912,1979,BGR,1472908889,1235337140,-237571749
2913,1979,BHR,2404792998,1654335398,-750457600
2914,1979,BHS,1497022587,2339228735,842206148
2915,1979,BLZ,148005806,85998311,-62007495
2916,1979,BMU,1504272413,83427811,-1420844602
2917,1979,BOL,827461316,718725028,-108736288
2918,1979,BRA,18297379801,15553402673,-2743977128
2919,1979,BRB,376173640,124230965,-251942675
2920,1979,BRN,460676498,2293720544,1833044046
2921,1979,BTN,15590567,2931782,-12658785
2922,1979,CAF,81442949,108625386,27182437
2923,1979,CAN,47075591993,56555106009,9479514016
2924,1979,CCK,5940371,1579210,-4361161
2925,1979,CHE,32850632580,25882887412,-6967745168
2926,1979,CHL,3887741031,3913636477,25895446
2927,1979,CHN,12162503452,11882436144,-280067308
2928,1979,CIV,2389399570,3239094913,849695343
2929,1979,CMR,1237262092,1230408224,-6853868
2930,1979,COD,930471540,1820382755,889911215
2931,1979,COG,378141319,550036117,171894798
2932,1979,COK,5539099,1009482,-4529617
2933,1979,COL,3637051890,3798369091,161317201
2934,1979,COM,41786309,25158464,-16627845
2935,1979,CPV,82848489,2974536,-79873953
2936,1979,CRI,1315176083,1086291310,-228884773
2937,1979,CUB,1161701927,766573659,-395128268
2938,1979,CXR,15126710,41903955,26777245
2939,1979,CYM,69865226,5749945,-64115281
2940,1979,CYP,1058645011,502979588,-555665423
2941,1979,DEU,1.44E+11,1.61E+11,17097725597
2942,1979,DJI,156372870,35233326,-121139544
2943,1979,DMA,60563981,56598261,-3965720
2944,1979,DNK,17075792735,13978485352,-3097307383
2945,1979,DOM,1302844761,910842115,-392002646
2946,1979,DZA,7833780121,9872953873,2039173752
2947,1979,ECU,2061221002,1889705782,-171515220
2948,1979,EGY,7180454302,3303382752,-3877071550
2949,1979,ESH,2125490,2270691,145201
2950,1979,ESP,24053976955,17881461339,-6172515616
2951,1979,ETH,584728892,397215374,-187513518
2952,1979,FIN,8568897587,9973758355,1404860768
2953,1979,FJI,419394293,228952866,-190441427
2954,1979,FLK,4559018,8864444,4305426
2955,1979,FRA,1.05E+11,94200686391,-10381406266
2956,1979,FRO,186414411,129274700,-57139711
2957,1979,GAB,502067717,1876550533,1374482816
2958,1979,GBR,91373934111,88275879808,-3098054303
2959,1979,GHA,886054390,1017919747,131865357
2960,1979,GIB,247616218,15347736,-232268482
2961,1979,GIN,186975614,296137694,109162080
2962,1979,GMB,120906677,42036317,-78870360
2963,1979,GNB,49088284,15031790,-34056494
2964,1979,GNQ,13705722,6843445,-6862277
2965,1979,GRC,11348317095,4883816285,-6464500810
2966,1979,GRD,40212566,23589760,-16622806
2967,1979,GRL,249584413,137398772,-112185641
2968,1979,GTM,1485139608,1463593828,-21545780
2969,1979,GUY,279790904,338251180,58460276
2970,1979,HKG,16952907819,15141716284,-1811191535
2971,1979,HND,774353350,840241364,65888014
2972,1979,HTI,417536333,295876011,-121660322
2973,1979,HUN,3916603002,3124975984,-791627018
2974,1979,IDN,7735866592,17789432496,10053565904
2975,1979,IND,8708408423,7538406625,-1170001798
2976,1979,IOT,1025799,84924,-940875
2977,1979,IRL,10159453523,7293068468,-2866385055
2978,1979,IRN,6456805847,17026711673,10569905826
2979,1979,IRQ,8097985080,18411984898,10313999818
2980,1979,ISL,610548982,749768061,139219079
2981,1979,ISR,6234631597,3911295239,-2323336358
2982,1979,ITA,72821538205,68041363499,-4780174706
2983,1979,JAM,975606189,864417115,-111189074
2984,1979,JOR,1891339826,396662935,-1494676891
2985,1979,JPN,1.00E+11,1.01E+11,384717962
2986,1979,KEN,1605683144,1158610094,-447073050
2987,1979,KHM,24074391,4103121,-19971270
2988,1979,KIR,17334604,15330442,-2004162
2989,1979,KNA,137265103,38287644,-98977459
2990,1979,KOR,19400623344,14556124648,-4844498696
2991,1979,KWT,5222530887,16893158146,11670627259
2992,1979,LAO,68605272,16830325,-51774947
2993,1979,LBN,2340043142,797270004,-1542773138
2994,1979,LBR,2674002697,1279848461,-1394154236
2995,1979,LBY,6843047322,14762429174,7919381852
2996,1979,LCA,92607567,7354516,-85253051
2997,1979,LKA,1379443840,924118491,-455325349
2998,1979,MAC,286980267,441026214,154045947
2999,1979,MAR,4086914480,2133849569,-1953064911
3000,1979,MDG,665941475,420557677,-245383798
3001,1979,MDV,10824540,6252446,-4572094
3002,1979,MEX,14473469427,12113579627,-2359889800
3003,1979,MLI,304061625,105871334,-198190291
3004,1979,MLT,749080050,369616413,-379463637
3005,1979,MMR,600426736,438754904,-161671832
3006,1979,MNG,21660354,20733180,-927174
3007,1979,MOZ,311741966,459203575,147461609
3008,1979,MRT,244000616,200377180,-43623436
3009,1979,MSR,59164626,19730682,-39433944
3010,1979,MUS,330086722,375231698,45144976
3011,1979,MWI,371841955,230405751,-141436204
3012,1979,MYS,8302464452,12691062613,4388598161
3013,1979,NCL,403010020,451979690,48969670
3014,1979,NER,412725576,321521889,-91203687
3015,1979,NGA,8346602375,17961034147,9614431772
3016,1979,NIC,378413580,688257295,309843715
3017,1979,NIU,475353,209139,-266214
3018,1979,NLD,73575984597,59932283537,-13643701060
3019,1979,NOR,12793703404,14561074256,1767370852
3020,1979,NPL,155822003,96446936,-59375067
3021,1979,NRU,22072962,92264001,70191039
3022,1979,NZL,4224423782,4743166827,518743045
3023,1979,OMN,1236324745,1951214070,714889325
3024,1979,PAK,4181665678,1989301085,-2192364593
3025,1979,PAN,3307163036,1326857342,-1980305694
3026,1979,PCN,186108,39051,-147057
3027,1979,PER,1780360108,3376186265,1595826157
3028,1979,PHL,6965266552,5280454098,-1684812454
3029,1979,PNG,797997890,916125188,118127298
3030,1979,POL,7214073657,5698345936,-1515727721
3031,1979,PRK,524745884,665291055,140545171
3032,1979,PRT,6528846295,3484297321,-3044548974
3033,1979,PRY,972187036,703894265,-268292771
3034,1979,PYF,310475022,32473157,-278001865
3035,1979,QAT,1248219082,3503422786,2255203704
3036,1979,REU,666135287,145948043,-520187244
3037,1979,ROU,4795057009,4458017239,-337039770
3038,1979,RWA,127934741,138252643,10317902
3039,1979,SAU,24164253089,63743112446,39578859357
3040,1979,SDN,1331090860,640987935,-690102925
3041,1979,SEN,983931535,516483467,-467448068
3042,1979,SGP,19386765994,14127282299,-5259483695
3043,1979,SHN,10186992,4107309,-6079683
3044,1979,SLB,62476475,73309560,10833085
3045,1979,SLE,231926033,181060976,-50865057
3046,1979,SLV,1049131746,1268051250,218919504
3047,1979,SOM,360713076,145876018,-214837058
3048,1979,SPM,28778037,4753469,-24024568
3049,1979,STP,16920246,22915903,5995657
3050,1979,SUR,350031787,471730034,121698247
3051,1979,SWE,25871551289,26394513025,522961736
3052,1979,SYC,85410299,4298591,-81111708
3053,1979,SYR,3038660243,1434090089,-1604570154
3054,1979,TCA,32630243,3640655,-28989588
3055,1979,TCD,54539811,69988546,15448735
3056,1979,TGO,511285854,243808112,-267477742
3057,1979,THA,7049878847,5717104901,-1332773946
3058,1979,TKL,84657,38357,-46300
3059,1979,TLS,357000,3887455,3530455
3060,1979,TON,40870497,6994028,-33876469
3061,1979,TTO,2172913786,2451823980,278910194
3062,1979,TUN,2631507158,1602407825,-1029099333
3063,1979,TUR,5019393192,2440609684,-2578783508
3064,1979,TUV,2555417,844555,-1710862
3065,1979,TWN,13739625511,16341169317,2601543806
3066,1979,TZA,1031335381,590696511,-440638870
3067,1979,UGA,190063757,387048890,196985133
3068,1979,URY,1295749105,813148663,-482600442
3069,1979,USA,2.12E+11,1.78E+11,-33781070273
3070,1979,VCT,11470410,6751309,-4719101
3071,1979,VEN,9523471753,13493780574,3970308821
3072,1979,VGB,6155984,225724,-5930260
3073,1979,VIR,100293726,26752051,-73541675
3074,1979,VNM,818421057,127444276,-690976781
3075,1979,VUT,47197364,34422342,-12775022
3076,1979,WLF,2029585,12757,-2016828
3077,1979,WSM,51592550,20562157,-31030393
3078,1979,YEM,1478986691,35773067,-1443213624
3079,1979,ZAF,8121041467,10956359286,2835317819
3080,1979,ZMB,766683378,1457561369,690877991
3081,1979,ZWE,22796477,13631290,-9165187
3082,1980,AGO,1178926226,1376783847,197857621
3083,1980,ALB,136046645,173534157,37487512
3084,1980,AND,459968207,20689794,-439278413
3085,1980,ANT,6927878738,5059818365,-1868060373
3086,1980,ARE,8067819888,19316191815,11248371927
3087,1980,ARG,11031052181,7081199601,-3949852580
3088,1980,ATG,45405316,13218948,-32186368
3089,1980,AUS,19476107583,21562037588,2085930005
3090,1980,AUT,21966148399,15983129378,-5983019021
3091,1980,BDI,104462433,110614294,6151861
3092,1980,BEL,69685196295,62460520280,-7224676015
3093,1980,BEN,585635717,76582308,-509053409
3094,1980,BFA,267989763,116970122,-151019641
3095,1980,BGD,2129485965,794564050,-1334921915
3096,1980,BGR,2079079100,1651877529,-427201571
3097,1980,BHR,3281122954,2156721634,-1124401320
3098,1980,BHS,3337638751,2474924803,-862713948
3099,1980,BLZ,148130155,111751254,-36378901
3100,1980,BMU,505206056,100100594,-405105462
3101,1980,BOL,761711212,884315729,122604517
3102,1980,BRA,23972274128,19540596732,-4431677396
3103,1980,BRB,440723972,184474194,-256249778
3104,1980,BRN,567371147,3839235821,3271864674
3105,1980,BTN,21707710,6802495,-14905215
3106,1980,CAF,85342283,118357610,33015327
3107,1980,CAN,51437771227,64310866319,12873095092
3108,1980,CCK,6163276,2044819,-4118457
3109,1980,CHE,41847186681,29369669705,-12477516976
3110,1980,CHL,5020476597,4653826511,-366650086
3111,1980,CHN,16723961283,16584145909,-139815374
3112,1980,CIV,2581321032,2929609864,348288832
3113,1980,CMR,1548813569,1742077134,193263565
3114,1980,COD,1122974106,2269774672,1146800566
3115,1980,COG,540975091,816163218,275188127
3116,1980,COK,16557337,7050612,-9506725
3117,1980,COL,4661270380,4352274278,-308996102
3118,1980,COM,48204682,14167943,-34036739
3119,1980,CPV,118292542,3125101,-115167441
3120,1980,CRI,1429603386,1156586499,-273016887
3121,1980,CUB,1962650250,1203342408,-759307842
3122,1980,CXR,20289913,80529612,60239699
3123,1980,CYM,147645159,10209905,-137435254
3124,1980,CYP,1296054952,624818071,-671236881
3125,1980,DEU,1.68E+11,1.77E+11,8975324919
3126,1980,DJI,233704253,39928590,-193775663
3127,1980,DMA,55466252,16462085,-39004167
3128,1980,DNK,17876461562,16069329591,-1807131971
3129,1980,DOM,1736728217,1107971651,-628756566
3130,1980,DZA,10104125813,13571889370,3467763557
3131,1980,ECU,2246851086,2736207973,489356887
3132,1980,EGY,9310937182,5008232570,-4302704612
3133,1980,ESH,2864386,4052406,1188020
3134,1980,ESP,31620998035,20811396859,-10809601176
3135,1980,ETH,580352512,425657849,-154694663
3136,1980,FIN,11200157476,11923530860,723373384
3137,1980,FJI,515202352,328800570,-186401782
3138,1980,FLK,4913298,8151473,3238175
3139,1980,FRA,1.29E+11,1.06E+11,-22646936884
3140,1980,FRO,191139130,155548992,-35590138
3141,1980,GAB,706695657,2407268065,1700572408
3142,1980,GBR,1.04E+11,1.06E+11,2255553441
3143,1980,GHA,1020732120,1079135098,58402978
3144,1980,GIB,266869165,15077892,-251791273
3145,1980,GIN,292640282,352432026,59791744
3146,1980,GMB,155019927,25615338,-129404589
3147,1980,GNB,102419373,12873169,-89546204
3148,1980,GNQ,62953693,19297846,-43655847
3149,1980,GRC,13859308815,5815118755,-8044190060
3150,1980,GRD,44053841,20538365,-23515476
3151,1980,GRL,291699812,174407006,-117292806
3152,1980,GTM,1672082071,1720854916,48772845
3153,1980,GUY,324920095,442989608,118069513
3154,1980,HKG,21914038620,19463213948,-2450824672
3155,1980,HND,926332328,914891127,-11441201
3156,1980,HTI,527949365,358185385,-169763980
3157,1980,HUN,4110784068,3739068295,-371715773
3158,1980,IDN,11918525720,24805770678,12887244958
3159,1980,IND,12274100179,7630102327,-4643997852
3160,1980,IOT,1024794,286211,-738583
3161,1980,IRL,10783292036,8647687886,-2135604150
3162,1980,IRN,9267760467,13046259189,3778498722
3163,1980,IRQ,11287556805,27207840563,15920283758
3164,1980,ISL,772934719,779067759,6133040
3165,1980,ISR,6348724770,4590821753,-1757903017
3166,1980,ITA,90413126690,73175828172,-17237298518
3167,1980,JAM,1088836086,994751632,-94084454
3168,1980,JOR,2691396660,551713265,-2139683395
3169,1980,JPN,1.27E+11,1.27E+11,143050157
3170,1980,KEN,2346835014,1412709823,-934125191
3171,1980,KHM,146525343,6198742,-140326601
3172,1980,KIR,25608627,5744919,-19863708
3173,1980,KNA,196794587,48074417,-148720170
3174,1980,KOR,20262123376,16539040793,-3723082583
3175,1980,KWT,6174091589,18270609665,12096518076
3176,1980,LAO,100809724,23652551,-77157173
3177,1980,LBN,3154064349,903160219,-2250904130
3178,1980,LBR,3129036158,1277670219,-1851365939
3179,1980,LBY,8542671049,21477976710,12935305661
3180,1980,LCA,102560384,33561436,-68998948
3181,1980,LKA,1918517810,1032252796,-886265014
3182,1980,MAC,413504880,608080085,194575205
3183,1980,MAR,4147366056,2590675511,-1556690545
3184,1980,MDG,664454211,445236741,-219217470
3185,1980,MDV,15777063,10348671,-5428392
3186,1980,MEX,21942813975,18585717777,-3357096198
3187,1980,MLI,415885667,210187305,-205698362
3188,1980,MLT,827926849,429633491,-398293358
3189,1980,MMR,570179072,437745768,-132433304
3190,1980,MNG,17553083,20113787,2560704
3191,1980,MOZ,557147984,485059676,-72088308
3192,1980,MRT,285773751,239597540,-46176211
3193,1980,MSR,51130441,10645916,-40484525
3194,1980,MUS,552899988,484579893,-68320095
3195,1980,MWI,356559245,306710492,-49848753
3196,1980,MYS,11091948141,15176193885,4084245744
3197,1980,NCL,504944222,504892890,-51332
3198,1980,NER,468288859,468367270,78411
3199,1980,NGA,13495180957,24629901293,11134720336
3200,1980,NIC,901536746,488973723,-412563023
3201,1980,NIU,2217741,293000,-1924741
3202,1980,NLD,86456260140,68081888726,-18374371414
3203,1980,NOR,15323690706,21326922268,6003231562
3204,1980,NPL,189923330,92267406,-97655924
3205,1980,NRU,34499088,122906895,88407807
3206,1980,NZL,4955996146,5514088004,558091858
3207,1980,OMN,1649117059,3184112654,1534995595
3208,1980,PAK,5217003324,2535329195,-2681674129
3209,1980,PAN,4572647279,1621132267,-2951515012
3210,1980,PCN,445678,250038,-195640
3211,1980,PER,2908046072,3831384052,923337980
3212,1980,PHL,8456893332,6593651536,-1863241796
3213,1980,PNG,984751839,1012821835,28069996
3214,1980,POL,8787962182,7622971489,-1164990693
3215,1980,PRK,712534530,829799442,117264912
3216,1980,PRT,9060675112,4497890183,-4562784929
3217,1980,PRY,1055072065,680308251,-374763814
3218,1980,PYF,389864532,19671380,-370193152
3219,1980,QAT,1226068149,5505559956,4279491807
3220,1980,REU,713547460,141141138,-572406322
3221,1980,ROU,5713594423,4720462747,-993131676
3222,1980,RWA,154190299,131074646,-23115653
3223,1980,SAU,28251396531,1.09E+11,80278767160
3224,1980,SDN,1684052766,665676876,-1018375890
3225,1980,SEN,1144383852,489442639,-654941213
3226,1980,SGP,27003078659,19842271459,-7160807200
3227,1980,SHN,11643796,3606328,-8037468
3228,1980,SLB,71997397,74449492,2452095
3229,1980,SLE,268596011,171105984,-97490027
3230,1980,SLV,952274351,1185142692,232868341
3231,1980,SOM,456956355,151923026,-305033329
3232,1980,SPM,33838450,6512307,-27326143
3233,1980,STP,27103991,21289432,-5814559
3234,1980,SUR,446536730,523290930,76754200
3235,1980,SWE,31291413869,29818894891,-1472518978
3236,1980,SYC,96534833,7842204,-88692629
3237,1980,SYR,4332351915,1924985816,-2407366099
3238,1980,TCA,4679144,3732204,-946940
3239,1980,TCD,36097384,68585820,32488436
3240,1980,TGO,596788378,367629529,-229158849
3241,1980,THA,9065965009,6916562683,-2149402326
3242,1980,TKL,359325,26660,-332665
3243,1980,TLS,118937,4488034,4369097
3244,1980,TON,36663867,8765612,-27898255
3245,1980,TTO,3399679408,3702651896,302972488
3246,1980,TUN,3464300394,2506876076,-957424318
3247,1980,TUR,7426741757,2793387872,-4633353885
3248,1980,TUV,4562183,269610,-4292573
3249,1980,TWN,17871621339,18953436453,1081815114
3250,1980,TZA,1134396388,585483379,-548913009
3251,1980,UGA,401641333,438143473,36502140
3252,1980,URY,1707611538,1020371495,-687240043
3253,1980,USA,2.45E+11,2.18E+11,-26550409365
3254,1980,VCT,47513540,24184131,-23329409
3255,1980,VEN,10239617011,18647575628,8407958617
3256,1980,VGB,13892672,4508253,-9384419
3257,1980,VIR,160569498,8761959,-151807539
3258,1980,VNM,693273479,123930803,-569342676
3259,1980,VUT,48666335,19956496,-28709839
3260,1980,WLF,2739186,53399,-2685787
3261,1980,WSM,57019111,20885623,-36133488
3262,1980,YEM,1721515108,24955588,-1696559520
3263,1980,ZAF,13270932621,12598899974,-672032647
3264,1980,ZMB,789821739,1397296473,607474734
3265,1980,ZWE,174908242,380293212,205384970
3266,1981,AGO,1391697081,1625900091,234203010
3267,1981,AIA,0,9662,9662
3268,1981,ALB,142679446,163567175,20887729
3269,1981,AND,383726463,15208604,-368517859
3270,1981,ANT,7739156963,5268618601,-2470538362
3271,1981,ARE,8495555627,19918019155,11422463528
3272,1981,ARG,9228924053,6971005339,-2257918714
3273,1981,ATG,127396694,10662634,-116734060
3274,1981,AUS,22993875270,21693284652,-1300590618
3275,1981,AUT,18514999906,14529593958,-3985405948
3276,1981,BDI,112808354,77759757,-35048597
3277,1981,BEL,60534319039,53855762536,-6678556503
3278,1981,BEN,699345765,42662990,-656682775
3279,1981,BFA,297380960,99435524,-197945436
3280,1981,BGD,1827114996,699502543,-1127612453
3281,1981,BGR,2495048508,1490004685,-1005043823
3282,1981,BHR,3951286597,2582797978,-1368488619
3283,1981,BHS,3432978228,1786481429,-1646496799
3284,1981,BLZ,156099821,95331397,-60768424
3285,1981,BMU,481836152,56185641,-425650511
3286,1981,BOL,930514027,886792398,-43721629
3287,1981,BRA,22261370518,22162729169,-98641349
3288,1981,BRB,479987899,166546796,-313441103
3289,1981,BRN,677829845,3713963230,3036133385
3290,1981,BTN,34863862,8406368,-26457494
3291,1981,CAF,64521937,130236929,65714992
3292,1981,CAN,58520036891,68210095264,9690058373
3293,1981,CCK,6332037,1492042,-4839995
3294,1981,CHE,32452877597,28916786161,-3536091436
3295,1981,CHL,5992572035,3992444484,-2000127551
3296,1981,CHN,15959643359,20340549631,4380906272
3297,1981,CIV,2293656074,2617055747,323399673
3298,1981,CMR,1425178582,1842577546,417398964
3299,1981,COD,1056467765,1859119191,802651426
3300,1981,COG,650026017,1065359245,415333228
3301,1981,COK,19965477,6112634,-13852843
3302,1981,COL,4951523984,3359329844,-1592194140
3303,1981,COM,59240535,26838035,-32402500
3304,1981,CPV,99536840,4261839,-95275001
3305,1981,CRI,1057450135,1156671178,99221043
3306,1981,CUB,1743691530,1269100111,-474591419
3307,1981,CXR,22064106,77512809,55448703
3308,1981,CYM,136855743,18861130,-117994613
3309,1981,CYP,1303649364,582505089,-721144275
3310,1981,DEU,1.45E+11,1.61E+11,15541338578
3311,1981,DJI,251709260,29539834,-222169426
3312,1981,DMA,62465140,36976355,-25488785
3313,1981,DNK,16325578683,15313700540,-1011878143
3314,1981,DOM,1678763208,1176652925,-502110283
3315,1981,DZA,9976952622,14350951892,4373999270
3316,1981,ECU,2411147348,2750688588,339541240
3317,1981,EGY,10622997656,5668513916,-4954483740
3318,1981,ESH,3072528,3242256,169728
3319,1981,ESP,30337087186,20151380132,-10185707054
3320,1981,ETH,580940127,380410278,-200529849
3321,1981,FIN,10231833714,10838976644,607142930
3322,1981,FJI,542595555,288801587,-253793968
3323,1981,FLK,6073530,5245213,-828317
3324,1981,FRA,1.13E+11,97958595543,-15500790861
3325,1981,FRO,173796839,156391462,-17405377
3326,1981,GAB,773141360,1970661549,1197520189
3327,1981,GBR,96859832812,1.00E+11,3541009210
3328,1981,GHA,1196748008,774975107,-421772901
3329,1981,GIB,243703767,13131272,-230572495
3330,1981,GIN,338130629,369609474,31478845
3331,1981,GMB,95796459,30268909,-65527550
3332,1981,GNB,76562776,18962105,-57600671
3333,1981,GNQ,41714440,28257851,-13456589
3334,1981,GRC,13289472160,5545258724,-7744213436
3335,1981,GRD,28236082,26136375,-2099707
3336,1981,GRL,246678133,206544448,-40133685
3337,1981,GTM,1647696429,1455890758,-191805671
3338,1981,GUY,387801018,432537174,44736156
3339,1981,HKG,24160897922,21332828157,-2828069765
3340,1981,HND,842140505,863562042,21421537
3341,1981,HTI,548021155,340342164,-207678991
3342,1981,HUN,4074238045,3434792044,-639446001
3343,1981,IDN,13445107357,26507382194,13062274837
3344,1981,IND,13985944621,7400863863,-6585080758
3345,1981,IOT,6136981,1071031,-5065950
3346,1981,IRL,10321602463,8121418053,-2200184410
3347,1981,IRN,9450057464,9211771800,-238285664
3348,1981,IRQ,16348073357,9958011780,-6390061577
3349,1981,ISL,828645401,763260303,-65385098
3350,1981,ISR,6501175987,4915890261,-1585285726
3351,1981,ITA,82187197310,71627423569,-10559773741
3352,1981,JAM,1410134410,1029952219,-380182191
3353,1981,JOR,3635823163,738726147,-2897097016
3354,1981,JPN,1.29E+11,1.48E+11,18740837229
3355,1981,KEN,1890679225,1177295921,-713383304
3356,1981,KHM,72821056,2219741,-70601315
3357,1981,KIR,21711967,2532632,-19179335
3358,1981,KNA,334292994,46259927,-288033067
3359,1981,KOR,22315346845,19318950288,-2996396557
3360,1981,KWT,7177349415,15739867959,8562518544
3361,1981,LAO,67516885,8679830,-58837055
3362,1981,LBN,2983141119,878225622,-2104915497
3363,1981,LBR,3443470360,1216918202,-2226552158
3364,1981,LBY,13917641325,17047454697,3129813372
3365,1981,LCA,112205764,40495827,-71709937
3366,1981,LKA,1833290010,996189711,-837100299
3367,1981,MAC,611337899,667700572,56362673
3368,1981,MAR,4219136090,2392581860,-1826554230
3369,1981,MDG,423887622,373563731,-50323891
3370,1981,MDV,31946991,14956446,-16990545
3371,1981,MEX,26758537679,23435499745,-3323037934
3372,1981,MLI,296167045,100148712,-196018333
3373,1981,MLT,762468615,379621151,-382847464
3374,1981,MMR,635728435,449195723,-186532712
3375,1981,MNG,15822990,28955774,13132784
3376,1981,MOZ,648646482,337744669,-310901813
3377,1981,MRT,378222190,343871912,-34350278
3378,1981,MSR,67442592,11897026,-55545566
3379,1981,MUS,489386083,358306725,-131079358
3380,1981,MWI,286806137,279570013,-7236124
3381,1981,MYS,12242997745,13717458346,1474460601
3382,1981,NCL,471455326,411993231,-59462095
3383,1981,NER,543750028,311948466,-231801562
3384,1981,NGA,16707124585,20044639581,3337514996
3385,1981,NIC,768866271,511463588,-257402683
3386,1981,NIU,3774424,714302,-3060122
3387,1981,NLD,74239266200,62949179368,-11290086832
3388,1981,NOR,14653541159,20600247793,5946706634
3389,1981,NPL,264813583,95510931,-169302652
3390,1981,NRU,27311574,102479873,75168299
3391,1981,NZL,5269080150,5614240133,345159983
3392,1981,OMN,2221694500,4225659906,2003965406
3393,1981,PAK,5277715920,2621432066,-2656283854
3394,1981,PAN,6017836541,1485707187,-4532129354
3395,1981,PCN,663908,311360,-352548
3396,1981,PER,3830438466,3229184345,-601254121
3397,1981,PHL,8903821608,6659861001,-2243960607
3398,1981,PNG,1077493475,873423374,-204070101
3399,1981,POL,5743992380,5517424858,-226567522
3400,1981,PRK,639247408,485913131,-153334277
3401,1981,PRT,9449217729,4056315904,-5392901825
3402,1981,PRY,1080364471,640269380,-440095091
3403,1981,PYF,362984144,18023056,-344961088
3404,1981,QAT,1422710846,5847319530,4424608684
3405,1981,REU,698152211,105755281,-592396930
3406,1981,ROU,5181165952,5015225903,-165940049
3407,1981,RWA,151052941,96638626,-54414315
3408,1981,SAU,33288429693,1.18E+11,84739673022
3409,1981,SDN,1723966947,640178189,-1083788758
3410,1981,SEN,1081378746,465449227,-615929519
3411,1981,SGP,28216879333,21274136679,-6942742654
3412,1981,SHN,13251336,1376127,-11875209
3413,1981,SLB,78912384,89620900,10708516
3414,1981,SLE,267347639,134187830,-133159809
3415,1981,SLV,1051634989,877887940,-173747049
3416,1981,SOM,411550591,138166984,-273383607
3417,1981,SPM,30910031,18300105,-12609926
3418,1981,STP,22854863,14746799,-8108064
3419,1981,SUR,459105126,484275936,25170810
3420,1981,SWE,25843488370,27562282977,1718794607
3421,1981,SYC,91567575,17277732,-74289843
3422,1981,SYR,4785152307,2121419784,-2663732523
3423,1981,TCA,8231599,3792743,-4438856
3424,1981,TCD,33446802,55666322,22219520
3425,1981,TGO,479591161,252945154,-226646007
3426,1981,THA,9283134716,7195243810,-2087890906
3427,1981,TKL,99930,81288,-18642
3428,1981,TLS,702126,6011359,5309233
3429,1981,TON,45684848,8605366,-37079482
3430,1981,TTO,3304138928,3600098751,295959823
3431,1981,TUN,3597645544,2092803678,-1504841866
3432,1981,TUR,8265681195,4333606273,-3932074922
3433,1981,TUV,3011875,190943,-2820932
3434,1981,TWN,18062315026,21688679345,3626364319
3435,1981,TZA,845141700,559309541,-285832159
3436,1981,UGA,300508072,262314975,-38193097
3437,1981,URY,1597775747,1167444415,-430331332
3438,1981,USA,2.61E+11,2.26E+11,-35453889707
3439,1981,VCT,22898135,31643325,8745190
3440,1981,VEN,11694559023,20115617596,8421058573
3441,1981,VGB,36601851,997372,-35604479
3442,1981,VNM,463138882,122825787,-340313095
3443,1981,VUT,40683503,29664935,-11018568
3444,1981,WLF,2259754,26704,-2233050
3445,1981,WSM,61916488,16275610,-45640878
3446,1981,YEM,1555848234,63248086,-1492600148
3447,1981,ZAF,15385041273,10583137620,-4801903653
3448,1981,ZMB,630786552,993357776,362571224
3449,1981,ZWE,451179621,631276456,180096835
3450,1982,AGO,855701808,1431501999,575800191
3451,1982,AIA,0,35768,35768
3452,1982,ALB,180316009,152428939,-27887070
3453,1982,AND,380045433,39698234,-340347199
3454,1982,ANT,5861777555,4645749580,-1216027975
3455,1982,ARE,8365119096,16618990844,8253871748
3456,1982,ARG,5396330662,6873397338,1477066676
3457,1982,ATG,28551664,11265242,-17286422
3458,1982,AUS,22279358347,21071636664,-1207721683
3459,1982,AUT,17240954306,14335885273,-2905069033
3460,1982,BDI,125864822,129199405,3334583
3461,1982,BEL,56630856600,50749012464,-5881844136
3462,1982,BEN,756372764,26520749,-729852015
3463,1982,BFA,306084837,76540057,-229544780
3464,1982,BGD,1838300547,691899926,-1146400621
3465,1982,BGR,1908616596,1310746850,-597869746
3466,1982,BHR,3409201050,1851935052,-1557265998
3467,1982,BHS,3239527889,1541541792,-1697986097
3468,1982,BLZ,130896524,82903087,-47993437
3469,1982,BMU,471227168,54895806,-416331362
3470,1982,BOL,464873089,767799386,302926297
3471,1982,BRA,19965112168,19837086651,-128025517
3472,1982,BRB,435201649,199962294,-235239355
3473,1982,BRN,793294854,3287804650,2494509796
3474,1982,BTN,8081824,1053402,-7028422
3475,1982,CAF,74713542,92148108,17434566
3476,1982,CAN,48833276164,66599730800,17766454636
3477,1982,CCK,7222740,6866733,-356007
3478,1982,CHE,29172024512,26913694254,-2258330258
3479,1982,CHL,3282631682,3788389340,505757658
3480,1982,CHN,14276562325,19762069901,5485507576
3481,1982,CIV,1844370791,2605340105,760969314
3482,1982,CMR,1512557723,1883257465,370699742
3483,1982,COD,931548769,1397945187,466396418
3484,1982,COG,824010064,1202229869,378219805
3485,1982,COK,21590274,5882467,-15707807
3486,1982,COL,5323592832,3290797542,-2032795290
3487,1982,COM,36737308,22655454,-14081854
3488,1982,CPV,95905178,2913146,-92992032
3489,1982,CRI,888525362,1042247385,153722023
3490,1982,CUB,1215977279,957532748,-258444531
3491,1982,CXR,13778152,78121026,64342874
3492,1982,CYM,243008464,23476149,-219532315
3493,1982,CYP,1351195790,541708134,-809487656
3494,1982,DEU,1.35E+11,1.62E+11,27417425882
3495,1982,DJI,228523941,15070226,-213453715
3496,1982,DMA,35213345,32042225,-3171120
3497,1982,DNK,15550641453,14580322001,-970319452
3498,1982,DOM,1467811812,853753948,-614057864
3499,1982,DZA,9318096121,13820829258,4502733137
3500,1982,ECU,2009363443,2775349018,765985575
3501,1982,EGY,10649203333,5094710498,-5554492835
3502,1982,ESH,2895454,1593254,-1302200
3503,1982,ESP,29680380986,20215536719,-9464844267
3504,1982,ETH,540746676,431232169,-109514507
3505,1982,FIN,9551581530,9854581899,303000369
3506,1982,FJI,489745809,227529445,-262216364
3507,1982,FLK,10621597,5276409,-5345188
3508,1982,FRA,1.11E+11,89527218974,-21831019407
3509,1982,FRO,178916649,153539692,-25376957
3510,1982,GAB,708507752,1914265640,1205757888
3511,1982,GBR,93106539472,94691039837,1584500365
3512,1982,GHA,877641459,894686007,17044548
3513,1982,GIB,229685914,12464828,-217221086
3514,1982,GIN,266448182,401742678,135294496
3515,1982,GMB,87679603,38512771,-49166832
3516,1982,GNB,85498541,7659631,-77838910
3517,1982,GNQ,38813435,25630826,-13182609
3518,1982,GRC,11135325630,4983369645,-6151955985
3519,1982,GRD,25784423,16605156,-9179267
3520,1982,GRL,247787888,183314010,-64473878
3521,1982,GTM,1267235917,1260652485,-6583432
3522,1982,GUY,239530146,300871153,61341007
3523,1982,HKG,22936531791,20632226340,-2304305451
3524,1982,HND,665190382,782210912,117020530
3525,1982,HTI,485232964,390864202,-94368762
3526,1982,HUN,3460779504,3172458509,-288320995
3527,1982,IDN,16892248760,23639660033,6747411273
3528,1982,IND,11681892707,7499862799,-4182029908
3529,1982,IOT,3145273,918951,-2226322
3530,1982,IRL,9405575468,8196157882,-1209417586
3531,1982,IRN,7985251087,14474071462,6488820375
3532,1982,IRQ,16766709376,9052154315,-7714555061
3533,1982,ISL,787015192,682001535,-105013657
3534,1982,ISR,6457938697,4373402509,-2084536188
3535,1982,ITA,75275163419,69346913773,-5928249646
3536,1982,JAM,1286201434,835473016,-450728418
3537,1982,JOR,3701424782,689012059,-3012412723
3538,1982,JPN,1.21E+11,1.35E+11,14239238968
3539,1982,KEN,1597217984,1050658100,-546559884
3540,1982,KHM,47017349,3115969,-43901380
3541,1982,KIR,20674490,2675108,-17999382
3542,1982,KNA,225077363,40868586,-184208777
3543,1982,KOR,21437722158,20058422205,-1379299953
3544,1982,KWT,7658031870,9406613266,1748581396
3545,1982,LAO,70126166,19245449,-50880717
3546,1982,LBN,2779037844,750355408,-2028682436
3547,1982,LBR,3130016219,1194473889,-1935542330
3548,1982,LBY,6992415520,12919777926,5927362406
3549,1982,LCA,97506356,37299825,-60206531
3550,1982,LKA,1908784396,1058258942,-850525454
3551,1982,MAC,382816566,774036226,391219660
3552,1982,MAR,4163238156,2228828232,-1934409924
3553,1982,MDG,459960110,362948349,-97011761
3554,1982,MDV,59028684,20038081,-38990603
3555,1982,MEX,17462571930,25365983169,7903411239
3556,1982,MLI,340676716,71111515,-269565201
3557,1982,MLT,713542379,333667378,-379875001
3558,1982,MMR,707341739,398651837,-308689902
3559,1982,MNG,18580800,24774058,6193258
3560,1982,MOZ,632090844,282464770,-349626074
3561,1982,MRT,355683810,281036485,-74647325
3562,1982,MSR,46732056,15051239,-31680817
3563,1982,MUS,415090471,387376544,-27713927
3564,1982,MWI,272227345,264447370,-7779975
3565,1982,MYS,13094431623,13726681735,632250112
3566,1982,NCL,428685783,280221611,-148464172
3567,1982,NER,322192143,246808591,-75383552
3568,1982,NGA,11072192785,16188541233,5116348448
3569,1982,NIC,632072972,386542609,-245530363
3570,1982,NIU,3469439,505466,-2963973
3571,1982,NLD,71010312851,60811706426,-10198606425
3572,1982,NOR,14587164051,20004126121,5416962070
3573,1982,NPL,233713392,48387632,-185325760
3574,1982,NRU,23682242,85243793,61561551
3575,1982,NZL,5299347125,5557164022,257816897
3576,1982,OMN,2460476007,3108463510,647987503
3577,1982,PAK,5240998141,2330117734,-2910880407
3578,1982,PAN,6580253861,1514109336,-5066144525
3579,1982,PCN,1774903,55149,-1719754
3580,1982,PER,3061578428,3105339242,43760814
3581,1982,PHL,8415343598,5644104591,-2771239007
3582,1982,PNG,953599106,790304339,-163294767
3583,1982,POL,4408792354,5209484031,800691677
3584,1982,PRK,616090405,421246075,-194844330
3585,1982,PRT,8893498319,4057416617,-4836081702
3586,1982,PRY,846672978,550584716,-296088262
3587,1982,PYF,364757867,14194718,-350563149
3588,1982,QAT,1709147917,4296313039,2587165122
3589,1982,REU,711029449,71860749,-639168700
3590,1982,ROU,2900384738,3627791172,727406434
3591,1982,RWA,144905705,84376794,-60528911
3592,1982,SAU,36310995707,84815515629,48504519922
3593,1982,SDN,1771641561,579661777,-1191979784
3594,1982,SEN,906514815,418699272,-487815543
3595,1982,SGP,29124251621,22156760833,-6967490788
3596,1982,SHN,25521963,2405473,-23116490
3597,1982,SLB,65169614,68572553,3402939
3598,1982,SLE,164324032,109691712,-54632320
3599,1982,SLV,893236869,743886115,-149350754
3600,1982,SOM,462731211,128494316,-334236895
3601,1982,SPM,38629171,12463885,-26165286
3602,1982,STP,21832820,9654639,-12178181
3603,1982,SUR,427012747,398314285,-28698462
3604,1982,SWE,24839948089,26094080856,1254132767
3605,1982,SYC,91454081,11116382,-80337699
3606,1982,SYR,3812201479,1742512973,-2069688506
3607,1982,TCA,133181712,4749947,-128431765
3608,1982,TCD,56446092,42285843,-14160249
3609,1982,TGO,521411461,224064255,-297347206
3610,1982,THA,8085576143,7317075898,-768500245
3611,1982,TKL,331883,26233,-305650
3612,1982,TLS,660090,6700797,6040707
3613,1982,TON,41404754,5252493,-36152261
3614,1982,TTO,3383666733,3106288343,-277378390
3615,1982,TUN,3261996474,1654372171,-1607624303
3616,1982,TUR,8248272626,5281973096,-2966299530
3617,1982,TUV,4850015,86800,-4763215
3618,1982,TWN,16070397082,21273024439,5202627357
3619,1982,TZA,722512872,371575501,-350937371
3620,1982,UGA,262002528,358723346,96720818
3621,1982,URY,1121244250,1052206778,-69037472
3622,1982,USA,2.41E+11,2.04E+11,-36813207621
3623,1982,VCT,21515275,29516126,8000851
3624,1982,VEN,12265004350,16631446350,4366442000
3625,1982,VGB,7474904,955823,-6519081
3626,1982,VNM,352786274,174678546,-178107728
3627,1982,VUT,40940431,14309485,-26630946
3628,1982,WLF,1825731,46618,-1779113
3629,1982,WSM,48117790,15114011,-33003779
3630,1982,YEM,1333253455,71158304,-1262095151
3631,1982,ZAF,12233074735,9699590252,-2533484483
3632,1982,ZMB,594705971,756553779,161847808
3633,1982,ZWE,493674751,637007501,143332750
3634,1983,AGO,697890112,1777714143,1079824031
3635,1983,AIA,0,11036,11036
3636,1983,ALB,136596902,129957393,-6639509
3637,1983,AND,285258549,12599407,-272659142
3638,1983,ANT,3789113107,4453655860,664542753
3639,1983,ARE,7743739986,14607085190,6863345204
3640,1983,ARG,4549519973,7176882560,2627362587
3641,1983,ATG,32424046,11238858,-21185188
3642,1983,AUS,18863462534,19117092091,253629557
3643,1983,AUT,17495830719,14105977261,-3389853458
3644,1983,BDI,105781486,90062630,-15718856
3645,1983,BEL,53157673381,50321993196,-2835680185
3646,1983,BEN,356317242,76777118,-279540124
3647,1983,BFA,241929477,78770156,-163159321
3648,1983,BGD,1530052452,774206069,-755846383
3649,1983,BGR,2184751292,1249129582,-935621710
3650,1983,BHR,1448997342,1594991039,145993697
3651,1983,BHS,3348355600,1969173090,-1379182510
3652,1983,BLZ,88699350,69520191,-19179159
3653,1983,BMU,449863066,54843616,-395019450
3654,1983,BOL,376029190,860189297,484160107
3655,1983,BRA,16028444848,21535472747,5507027899
3656,1983,BRB,463625034,290334644,-173290390
3657,1983,BRN,813129406,2901224103,2088094697
3658,1983,BTN,12724691,1124939,-11599752
3659,1983,CAF,60677322,138695735,78018413
3660,1983,CAN,53907732141,70424776862,16517044721
3661,1983,CCK,5300362,2516701,-2783661
3662,1983,CHE,29931800348,26816336991,-3115463357
3663,1983,CHL,2699927840,3893657973,1193730133
3664,1983,CHN,16131396540,20041889708,3910493168
3665,1983,CIV,1612267205,2476793539,864526334
3666,1983,CMR,1171657146,1785621918,613964772
3667,1983,COD,872313995,1340181763,467867768
3668,1983,COG,569355085,1085034350,515679265
3669,1983,COK,19473311,5505317,-13967994
3670,1983,COL,4398989412,3195146167,-1203843245
3671,1983,COM,44283339,17929702,-26353637
3672,1983,CPV,102771062,3145362,-99625700
3673,1983,CRI,927435077,1063601259,136166182
3674,1983,CUB,1288160469,774525585,-513634884
3675,1983,CXR,14921941,47166023,32244082
3676,1983,CYM,104971311,23162001,-81809310
3677,1983,CYP,1410959531,514854029,-896105502
3678,1983,DEU,1.33E+11,1.54E+11,21212226678
3679,1983,DJI,241192739,15721321,-225471418
3680,1983,DMA,68983131,31261432,-37721699
3681,1983,DNK,15304006387,15172721585,-131284802
3682,1983,DOM,1412598733,942917763,-469680970
3683,1983,DZA,9346216910,13149598575,3803381665
3684,1983,ECU,1539844052,2644645773,1104801721
3685,1983,EGY,11321330849,4612871855,-6708458994
3686,1983,ESH,816260,92726,-723534
3687,1983,ESP,28025584038,19898605356,-8126978682
3688,1983,ETH,635740236,380198480,-255541756
3689,1983,FIN,8953192917,9536520242,583327325
3690,1983,FJI,459832061,220678030,-239154031
3691,1983,FLK,32806167,7594026,-25212141
3692,1983,FRA,1.02E+11,87247019322,-15185112845
3693,1983,FRO,209260013,145190820,-64069193
3694,1983,GAB,627387685,1771939301,1144551616
3695,1983,GBR,93419639172,89753765982,-3665873190
3696,1983,GHA,653217482,540412725,-112804757
3697,1983,GIB,156847770,28328233,-128519537
3698,1983,GIN,243370750,370906961,127536211
3699,1983,GMB,76026995,55226030,-20800965
3700,1983,GNB,70714758,12263574,-58451184
3701,1983,GNQ,19064534,22868593,3804059
3702,1983,GRC,10581680022,5194039975,-5387640047
3703,1983,GRD,27095114,19803120,-7291994
3704,1983,GRL,224093408,205335179,-18758229
3705,1983,GTM,1032041595,1166869720,134828125
3706,1983,GUY,179759469,250033869,70274400
3707,1983,HKG,23327580341,21577450962,-1750129379
3708,1983,HND,741379950,774512036,33132086
3709,1983,HTI,559735983,434574063,-125161920
3710,1983,HUN,3357774598,3252471524,-105303074
3711,1983,IDN,14715368708,22766917959,8051549251
3712,1983,IND,13574987205,8438011134,-5136976071
3713,1983,IOT,1799827,23294016,21494189
3714,1983,IRL,9038848713,8484857785,-553990928
3715,1983,IRN,14867162020,18572600639,3705438619
3716,1983,IRQ,7608432958,7908759214,300326256
3717,1983,ISL,619154612,709802379,90647767
3718,1983,ISR,6966047847,4482680908,-2483366939
3719,1983,ITA,70207697310,68501245838,-1706451472
3720,1983,JAM,1222455763,751159292,-471296471
3721,1983,JOR,2979972879,629969905,-2350002974
3722,1983,JPN,1.16E+11,1.44E+11,28311510382
3723,1983,KEN,1351311825,1037293962,-314017863
3724,1983,KHM,49066074,2517316,-46548758
3725,1983,KIR,22544105,3217982,-19326123
3726,1983,KNA,213454864,47625714,-165829150
3727,1983,KOR,22964173495,22281207898,-682965597
3728,1983,KWT,7173433997,9639091056,2465657059
3729,1983,LAO,74914047,22428340,-52485707
3730,1983,LBN,2625460870,588738123,-2036722747
3731,1983,LBR,2315374683,944275478,-1371099205
3732,1983,LBY,6500785380,13430032881,6929247501
3733,1983,LCA,83837177,48461108,-35376069
3734,1983,LKA,1870674767,1119508948,-751165819
3735,1983,MAC,616588467,807921227,191332760
3736,1983,MAR,3549495682,2250558723,-1298936959
3737,1983,MDG,388589922,314716647,-73873275
3738,1983,MDV,59168083,20118471,-39049612
3739,1983,MEX,12408186526,26685020213,14276833687
3740,1983,MLI,277377165,83656029,-193721136
3741,1983,MLT,663363773,302822042,-360541731
3742,1983,MMR,500671869,464517461,-36154408
3743,1983,MNG,16678580,13986677,-2691903
3744,1983,MOZ,528761225,228421578,-300339647
3745,1983,MRT,280935023,276299721,-4635302
3746,1983,MSR,35955048,6778305,-29176743
3747,1983,MUS,420437704,365702443,-54735261
3748,1983,MWI,240443654,264041718,23598064
3749,1983,MYS,13562948383,15174895113,1611946730
3750,1983,NCL,303554152,215265870,-88288282
3751,1983,NER,216449477,249343641,32894164
3752,1983,NGA,7830103400,13091202901,5261099501
3753,1983,NIC,659322897,445490626,-213832271
3754,1983,NIU,2837506,501253,-2336253
3755,1983,NLD,69780261416,60709975553,-9070285863
3756,1983,NOR,12925882225,19116733508,6190851283
3757,1983,NPL,265223200,77783207,-187439993
3758,1983,NRU,29776887,113089138,83312251
3759,1983,NZL,4946306255,5284775904,338469649
3760,1983,OMN,2258166046,3846472347,1588306301
3761,1983,PAK,5360610342,3032772518,-2327837824
3762,1983,PAN,5267299140,1488962834,-3778336306
3763,1983,PCN,1593059,266289,-1326770
3764,1983,PER,2157405377,2822999814,665594437
3765,1983,PHL,8416310572,5716141163,-2700169409
3766,1983,PNG,975219726,818498230,-156721496
3767,1983,POL,4271216539,5425463205,1154246666
3768,1983,PRK,608471329,451546953,-156924376
3769,1983,PRT,7820407261,4401304787,-3419102474
3770,1983,PRY,615923885,508866409,-107057476
3771,1983,PYF,373694738,12727972,-360966766
3772,1983,QAT,1332193128,3363641587,2031448459
3773,1983,REU,731066820,91308746,-639758074
3774,1983,ROU,2828941908,4061860923,1232919015
3775,1983,RWA,143561427,92748004,-50813423
3776,1983,SAU,35472732411,46884597577,11411865166
3777,1983,SDN,1129254650,583477282,-545777368
3778,1983,SEN,880644320,416757756,-463886564
3779,1983,SGP,29136590554,24355897738,-4780692816
3780,1983,SHN,29161451,2608543,-26552908
3781,1983,SLB,84311224,68624371,-15686853
3782,1983,SLE,162894779,135910040,-26984739
3783,1983,SLV,960030718,861674097,-98356621
3784,1983,SOM,283934665,120839829,-163094836
3785,1983,SPM,33480396,17480909,-15999487
3786,1983,STP,7836951,7025562,-811389
3787,1983,SUR,360212234,375473556,15261322
3788,1983,SWE,23464106336,26753099202,3288992866
3789,1983,SYC,80345369,33191802,-47153567
3790,1983,SYR,3671620531,1758139735,-1913480796
3791,1983,TCA,15599912,4966057,-10633855
3792,1983,TCD,47703314,113929191,66225877
3793,1983,TGO,563565749,203884890,-359680859
3794,1983,THA,9830962736,6905058625,-2925904111
3795,1983,TKL,26321,12479,-13842
3796,1983,TLS,608301,9147406,8539105
3797,1983,TON,37593862,5256107,-32337755
3798,1983,TTO,2925801360,2146114725,-779686635
3799,1983,TUN,3010233363,1630618883,-1379614480
3800,1983,TUR,8333169843,5405709327,-2927460516
3801,1983,TUV,2725929,152518,-2573411
3802,1983,TWN,15393391590,24872392209,9479000619
3803,1983,TZA,602925979,380808702,-222117277
3804,1983,UGA,260476258,332134927,71658669
3805,1983,URY,734440648,1155086608,420645960
3806,1983,USA,2.61E+11,1.94E+11,-66762877008
3807,1983,VCT,21670157,41526339,19856182
3808,1983,VEN,5926601139,13954942600,8028341461
3809,1983,VGB,21915932,3263046,-18652886
3810,1983,VNM,341649384,197355545,-144293839
3811,1983,VUT,47261759,15477708,-31784051
3812,1983,WLF,2047695,56527,-1991168
3813,1983,WSM,49529763,18136661,-31393102
3814,1983,YEM,1109941568,32487257,-1077454311
3815,1983,ZAF,10928664598,8756385671,-2172278927
3816,1983,ZMB,364508021,825721427,461213406
3817,1983,ZWE,456948327,634841082,177892755
3818,1984,AGO,895804668,2022359177,1126554509
3819,1984,AIA,21968,16379,-5589
3820,1984,ALB,121074281,123383476,2309195
3821,1984,AND,286086361,13131251,-272955110
3822,1984,ANT,4196383063,3907573385,-288809678
3823,1984,ARE,6601115700,14344953975,7743838275
3824,1984,ARG,4706968838,7957482403,3250513565
3825,1984,ATG,37399840,4271008,-33128832
3826,1984,AUS,22127046414,22283227767,156181353
3827,1984,AUT,18040308563,14427289389,-3613019174
3828,1984,BDI,120007295,93915037,-26092258
3829,1984,BEL,53716998699,50426549466,-3290449233
3830,1984,BEN,274695299,111305748,-163389551
3831,1984,BFA,130127144,55075104,-75052040
3832,1984,BGD,2181840408,965136536,-1216703872
3833,1984,BGR,2256001834,1254792248,-1001209586
3834,1984,BHR,1375493268,1805753396,430260128
3835,1984,BHS,3301610226,1497498769,-1804111457
3836,1984,BLZ,121462499,87390813,-34071686
3837,1984,BMU,642319747,63325705,-578994042
3838,1984,BOL,625827485,705659398,79831913
3839,1984,BRA,14711435002,27408506465,12697071463
3840,1984,BRB,523963117,330490348,-193472769
3841,1984,BRN,765154494,2759242787,1994088293
3842,1984,BTN,8461273,1556882,-6904391
3843,1984,CAF,62484589,129696637,67212048
3844,1984,CAN,65068878211,85471610828,20402732617
3845,1984,CCK,5211966,3347217,-1864749
3846,1984,CHE,29397833973,27698827332,-1699006641
3847,1984,CHL,3175615209,3832370740,656755531
3848,1984,CHN,22900281144,23941283519,1041002375
3849,1984,CIV,1179772823,2378500203,1198727380
3850,1984,CMR,1256695361,2240597619,983902258
3851,1984,COD,1028085355,1633006656,604921301
3852,1984,COG,469775990,1337598639,867822649
3853,1984,COK,18545511,5447755,-13097756
3854,1984,COL,4182189973,3674300703,-507889270
3855,1984,COM,55782160,12049241,-43732919
3856,1984,CPV,86335582,2591338,-83744244
3857,1984,CRI,1043338016,1128261161,84923145
3858,1984,CUB,1848760630,604076898,-1244683732
3859,1984,CXR,15927939,46302757,30374818
3860,1984,CYM,130654087,32394948,-98259139
3861,1984,CYP,1521036925,582035613,-939001312
3862,1984,DEU,1.34E+11,1.57E+11,23568051641
3863,1984,DJI,246916146,19273634,-227642512
3864,1984,DMA,56077974,35138104,-20939870
3865,1984,DNK,15991364020,15307513687,-683850333
3866,1984,DOM,1306040212,1151401467,-154638745
3867,1984,DZA,9698629438,13051088645,3352459207
3868,1984,ECU,1677051837,2732682691,1055630854
3869,1984,EGY,12111183675,4936607307,-7174576368
3870,1984,ESH,108363,1676509,1568146
3871,1984,ESP,27476073675,22892110499,-4583963176
3872,1984,ETH,781335414,400065863,-381269551
3873,1984,FIN,9123373753,10853642531,1730268778
3874,1984,FJI,406040128,222876702,-183163426
3875,1984,FLK,13566279,8259963,-5306316
3876,1984,FRA,1.01E+11,89888970074,-11145348312
3877,1984,FRO,227779070,142249346,-85529724
3878,1984,GAB,642179342,1925328185,1283148843
3879,1984,GBR,99592069225,92379211395,-7212857830
3880,1984,GHA,632767789,443433940,-189333849
3881,1984,GIB,117164688,17967945,-99196743
3882,1984,GIN,272647657,429682099,157034442
3883,1984,GMB,78378478,41603828,-36774650
3884,1984,GNB,64838205,11958395,-52879810
3885,1984,GNQ,22949365,29722133,6772768
3886,1984,GRC,10094010304,5240680235,-4853330069
3887,1984,GRD,51956977,16455626,-35501351
3888,1984,GRL,253637878,206848655,-46789223
3889,1984,GTM,1262436413,1195671301,-66765112
3890,1984,GUY,192868124,259394872,66526748
3891,1984,HKG,28210252241,27367689635,-842562606
3892,1984,HND,815653061,793278922,-22374139
3893,1984,HTI,594350141,464915918,-129434223
3894,1984,HUN,3264280422,3560927574,296647152
3895,1984,IDN,13287301860,23468010865,10180709005
3896,1984,IND,14731626356,8944687767,-5786938589
3897,1984,IOT,494541,351996,-142545
3898,1984,IRL,9386612299,9444935040,58322741
3899,1984,IRN,11622346490,14402500148,2780153658
3900,1984,IRQ,7576843888,8422271693,845427805
3901,1984,ISL,655299171,684186810,28887639
3902,1984,ISR,6822331144,5118804927,-1703526217
3903,1984,ITA,73324461954,69410440089,-3914021865
3904,1984,JAM,1123396883,763965600,-359431283
3905,1984,JOR,2850929891,837013903,-2013915988
3906,1984,JPN,1.23E+11,1.67E+11,44196713312
3907,1984,KEN,1570542773,1174160523,-396382250
3908,1984,KHM,42468562,3759413,-38709149
3909,1984,KIR,17579880,6322402,-11257478
3910,1984,KNA,246961718,53178553,-193783165
3911,1984,KOR,25717174371,26737411501,1020237130
3912,1984,KWT,6500695430,10338461080,3837765650
3913,1984,LAO,34912261,6823986,-28088275
3914,1984,LBN,2164147949,461868112,-1702279837
3915,1984,LBR,2361460601,870866713,-1490593888
3916,1984,LBY,5708209902,10645895624,4937685722
3917,1984,LCA,33164100,45631810,12467710
3918,1984,LKA,1878398162,1356882103,-521516059
3919,1984,MAC,769773291,1029704055,259930764
3920,1984,MAR,3812438104,2315837915,-1496600189
3921,1984,MDG,393822580,341635194,-52187386
3922,1984,MDV,66622211,23571762,-43050449
3923,1984,MEX,15817118396,28781466641,12964348245
3924,1984,MLI,214883659,119427281,-95456378
3925,1984,MLT,666418680,348623284,-317795396
3926,1984,MMR,452703143,420359265,-32343878
3927,1984,MNG,11632763,29929474,18296711
3928,1984,MOZ,419683023,128438973,-291244050
3929,1984,MRT,270813393,272393818,1580425
3930,1984,MSR,55805243,6224957,-49580286
3931,1984,MUS,464699972,387284516,-77415456
3932,1984,MWI,240927142,299064105,58136963
3933,1984,MYS,14359420430,18575364969,4215944539
3934,1984,NCL,348834291,244416761,-104417530
3935,1984,NER,167194450,229724261,62529811
3936,1984,NGA,5563729044,14271879524,8708150480
3937,1984,NIC,599025174,416771945,-182253229
3938,1984,NIU,2217302,199054,-2018248
3939,1984,NLD,69329023258,62715126588,-6613896670
3940,1984,NOR,13308047635,19973689976,6665642341
3941,1984,NPL,214473627,102701642,-111771985
3942,1984,NRU,20898502,71992310,51093808
3943,1984,NZL,5577542487,5521316325,-56226162
3944,1984,OMN,2572806757,4039953222,1467146465
3945,1984,PAK,5889206255,2463465384,-3425740871
3946,1984,PAN,6754553735,1787557858,-4966995877
3947,1984,PCN,1311380,27810,-1283570
3948,1984,PER,2027891681,3093720796,1065829115
3949,1984,PHL,6550128822,6285635581,-264493241
3950,1984,PNG,893657508,959369274,65711766
3951,1984,POL,4440967569,5723274526,1282306957
3952,1984,PRK,745746361,415221574,-330524787
3953,1984,PRT,7404092538,5106242071,-2297850467
3954,1984,PRY,743229052,516214682,-227014370
3955,1984,PYF,274974936,23368175,-251606761
3956,1984,QAT,1030100068,4463260446,3433160378
3957,1984,REU,698792481,82671613,-616120868
3958,1984,ROU,3253195285,5369476355,2116281070
3959,1984,RWA,140097790,130296878,-9800912
3960,1984,SAU,29917975875,39557607299,9639631424
3961,1984,SDN,1306346782,741993011,-564353771
3962,1984,SEN,823006367,389799434,-433206933
3963,1984,SGP,29026945705,23049646482,-5977299223
3964,1984,SHN,14322509,6628173,-7694336
3965,1984,SLB,77865890,84629631,6763741
3966,1984,SLE,155779942,169484337,13704395
3967,1984,SLV,1252162454,842048762,-410113692
3968,1984,SOM,274250510,64129725,-210120785
3969,1984,SPM,44163662,9380198,-34783464
3970,1984,STP,10334249,8171579,-2162670
3971,1984,SUR,334987496,331053484,-3934012
3972,1984,SWE,24499222901,28637902310,4138679409
3973,1984,SYC,75843816,22796178,-53047638
3974,1984,SYR,3468815029,1773126525,-1695688504
3975,1984,TCA,21364030,5202969,-16161061
3976,1984,TCD,76830675,82008712,5178037
3977,1984,TGO,303380637,208678965,-94701672
3978,1984,THA,9526401610,7860082004,-1666319606
3979,1984,TKL,85418,529037,443619
3980,1984,TLS,690595,13233306,12542711
3981,1984,TON,37806529,8183310,-29623219
3982,1984,TTO,2823971991,2184480981,-639491010
3983,1984,TUN,2899984184,1543907267,-1356076917
3984,1984,TUR,9683290888,6336487008,-3346803880
3985,1984,TUV,3410906,273965,-3136941
3986,1984,TWN,17103213920,30522557896,13419343976
3987,1984,TZA,650544397,411764722,-238779675
3988,1984,UGA,249236765,384738853,135502088
3989,1984,URY,776291054,1142978855,366687801
3990,1984,USA,3.26E+11,2.10E+11,-1.16E+11
3991,1984,VCT,24054745,37747776,13693031
3992,1984,VEN,6994776387,15519890238,8525113851
3993,1984,VGB,10823018,2180041,-8642977
3994,1984,VNM,426796211,229222537,-197573674
3995,1984,VUT,64564928,33014709,-31550219
3996,1984,WLF,5321067,17521,-5303546
3997,1984,WSM,51155199,20602536,-30552663
3998,1984,YEM,1115262143,107145133,-1008117010
3999,1984,ZAF,12178051861,9790559097,-2387492764
4000,1984,ZMB,397095662,794623630,397527968
4001,1984,ZWE,822863171,1058621046,235757875
4002,1985,AGO,1157790151,2130368392,972578241
4003,1985,AIA,1040302,7982,-1032320
4004,1985,ALB,117604454,94540930,-23063524
4005,1985,AND,327811679,16355621,-311456058
4006,1985,ANT,1105908342,1686879105,580970763
4007,1985,ARE,6610810165,14446103710,7835293545
4008,1985,ARG,3708052629,8188049984,4479997355
4009,1985,ATG,47901767,3391693,-44510074
4010,1985,AUS,22811164090,22933884449,122720359
4011,1985,AUT,19778787632,15961439639,-3817347993
4012,1985,BDI,102028003,94680091,-7347912
4013,1985,BEL,55126317252,52086590335,-3039726917
4014,1985,BEN,372258337,153871165,-218387172
4015,1985,BFA,244184469,40740943,-203443526
4016,1985,BGD,2364558240,1031700082,-1332858158
4017,1985,BGR,2873788638,1224173055,-1649615583
4018,1985,BHR,1224612521,1359212378,134599857
4019,1985,BHS,2309906747,975060406,-1334846341
4020,1985,BLZ,108205843,80007119,-28198724
4021,1985,BMU,508422167,106408117,-402014050
4022,1985,BOL,611597890,591351742,-20246148
4023,1985,BRA,14089141566,27208350865,13119209299
4024,1985,BRB,435940791,262238278,-173702513
4025,1985,BRN,658116601,2615398046,1957281445
4026,1985,BTN,4131109,918371,-3212738
4027,1985,CAF,90403374,99297346,8893972
4028,1985,CAN,68666764283,85812514369,17145750086
4029,1985,CCK,5589068,2609463,-2979605
4030,1985,CHE,30898955805,28229631325,-2669324480
4031,1985,CHL,2729834258,4008630604,1278796346
4032,1985,CHN,35786497913,26763270436,-9023227477
4033,1985,CIV,1541852480,3099650251,1557797771
4034,1985,CMR,1279795621,2355196037,1075400416
4035,1985,COD,1155818540,1584343019,428524479
4036,1985,COG,527153111,1101920924,574767813
4037,1985,COK,20036033,4999660,-15036373
4038,1985,COL,3979730992,3768892750,-210838242
4039,1985,COM,64611464,17721323,-46890141
4040,1985,CPV,97436587,5194275,-92242312
4041,1985,CRI,1069930182,1132331573,62401391
4042,1985,CUB,1926967036,614709934,-1312257102
4043,1985,CXR,10450831,40573010,30122179
4044,1985,CYM,110471175,29999376,-80471799
4045,1985,CYP,1537237403,591328142,-945909261
4046,1985,DEU,1.42E+11,1.75E+11,33186584700
4047,1985,DJI,253978423,10663750,-243314673
4048,1985,DMA,66274188,34706515,-31567673
4049,1985,DNK,17259912237,15969789568,-1290122669
4050,1985,DOM,1503356999,1098008242,-405348757
4051,1985,DZA,8867759452,13321040689,4453281237
4052,1985,ECU,1829267588,3379006632,1549739044
4053,1985,EGY,10583491828,4862378687,-5721113141
4054,1985,ESH,187942,152961,-34981
4055,1985,ESP,29106783438,23555036191,-5551747247
4056,1985,ETH,946541531,310141888,-636399643
4057,1985,FIN,10076312499,10721845232,645532733
4058,1985,FJI,388317003,192429693,-195887310
4059,1985,FLK,13016127,12607135,-408992
4060,1985,FRA,1.08E+11,93778782908,-14367088767
4061,1985,FRO,241461490,174322405,-67139085
4062,1985,GAB,767575286,1835374453,1067799167
4063,1985,GBR,1.01E+11,99586168443,-1380498565
4064,1985,GHA,693632746,507297601,-186335145
4065,1985,GIB,191946359,21781003,-170165356
4066,1985,GIN,333760254,423441650,89681396
4067,1985,GMB,85600750,23061504,-62539246
4068,1985,GNB,68690947,14018647,-54672300
4069,1985,GNQ,19522255,28485342,8963087
4070,1985,GRC,10663485730,5072480399,-5591005331
4071,1985,GRD,62346463,18875340,-43471123
4072,1985,GRL,270732091,232684559,-38047532
4073,1985,GTM,1224944668,1146410854,-78533814
4074,1985,GUY,176139697,227830241,51690544
4075,1985,HKG,29355704985,29179960877,-175744108
4076,1985,HND,789687482,825260226,35572744
4077,1985,HTI,578834460,467345308,-111489152
4078,1985,HUN,3512826076,3455838887,-56987189
4079,1985,IDN,9641189140,20627251397,10986062257
4080,1985,IND,15260997691,8472079631,-6788918060
4081,1985,IOT,1377146,2804729,1427583
4082,1985,IRL,9742946362,10259993030,517046668
4083,1985,IRN,9028106607,12954471986,3926365379
4084,1985,IRQ,7809162566,9766022841,1956860275
4085,1985,ISL,686565495,806009159,119443664
4086,1985,ISR,6784157295,5504981084,-1279176211
4087,1985,ITA,78157080427,74950660485,-3206419942
4088,1985,JAM,1031100141,664215823,-366884318
4089,1985,JOR,2835742232,931624378,-1904117854
4090,1985,JPN,1.18E+11,1.74E+11,56104126069
4091,1985,KEN,1508411619,1137851735,-370559884
4092,1985,KHM,24648345,3376026,-21272319
4093,1985,KIR,14896618,2391618,-12505000
4094,1985,KNA,248944167,104257321,-144686846
4095,1985,KOR,26220493062,27921399772,1700906710
4096,1985,KWT,5231712788,7705559015,2473846227
4097,1985,LAO,48932131,8561777,-40370354
4098,1985,LBN,1555406778,346105398,-1209301380
4099,1985,LBR,2493404694,899877918,-1593526776
4100,1985,LBY,4686711975,12731107216,8044395241
4101,1985,LCA,102082296,63110257,-38972039
4102,1985,LKA,1926387288,1320232892,-606154396
4103,1985,MAC,735796583,1032339141,296542558
4104,1985,MAR,3807547942,2378852873,-1428695069
4105,1985,MDG,318830090,295048789,-23781301
4106,1985,MDV,65806014,30737494,-35068520
4107,1985,MEX,17881197920,28356980836,10475782916
4108,1985,MLI,340712878,87370568,-253342310
4109,1985,MLT,676895458,371973604,-304921854
4110,1985,MMR,477735172,375683557,-102051615
4111,1985,MNG,18516920,35080880,16563960
4112,1985,MOZ,317866959,129808215,-188058744
4113,1985,MRT,270702114,319449466,48747352
4114,1985,MSR,52600728,9056023,-43544705
4115,1985,MUS,494523108,460494938,-34028170
4116,1985,MWI,252248323,302973288,50724965
4117,1985,MYS,12293661948,17325984403,5032322455
4118,1985,NCL,346599754,311309195,-35290559
4119,1985,NER,234310570,204976969,-29333601
4120,1985,NGA,6238309466,15265521371,9027211905
4121,1985,NIC,650252692,299592303,-350660389
4122,1985,NIU,2727318,149887,-2577431
4123,1985,NLD,73625621313,64452342050,-9173279263
4124,1985,NOR,15152420658,19097996584,3945575926
4125,1985,NPL,246180977,139881286,-106299691
4126,1985,NRU,30068845,70730750,40661905
4127,1985,NZL,5231801764,5824015906,592214142
4128,1985,OMN,3048336406,4517482502,1469146096
4129,1985,PAK,6049256552,2727103453,-3322153099
4130,1985,PAN,7023639395,1947306962,-5076332433
4131,1985,PCN,769928,332314,-437614
4132,1985,PER,1666386562,3019297103,1352910541
4133,1985,PHL,5654685829,5815982787,161296958
4134,1985,PNG,801410949,952877038,151466089
4135,1985,POL,4579155847,5573980942,994825095
4136,1985,PRK,722343403,376762887,-345580516
4137,1985,PRT,7308456283,5602389812,-1706066471
4138,1985,PRY,705143652,449902966,-255240686
4139,1985,PYF,317493150,21181193,-296311957
4140,1985,QAT,1036121980,3155006767,2118884787
4141,1985,REU,730786562,67626215,-663160347
4142,1985,ROU,2946627592,4890859944,1944232352
4143,1985,RWA,147689849,127158585,-20531264
4144,1985,SAU,22789715918,26300884540,3511168622
4145,1985,SDN,1469469931,462067628,-1007402303
4146,1985,SEN,725216982,369561281,-355655701
4147,1985,SGP,26178362137,21084160156,-5094201981
4148,1985,SHN,12584189,7591153,-4993036
4149,1985,SLB,77965715,94723578,16757863
4150,1985,SLE,159004577,148887212,-10117365
4151,1985,SLV,1232292048,830820752,-401471296
4152,1985,SOM,244428023,131521030,-112906993
4153,1985,SPM,36309137,15403034,-20906103
4154,1985,STP,10617054,5776668,-4840386
4155,1985,SUR,248163265,309348459,61185194
4156,1985,SWE,26435814549,29815251496,3379436947
4157,1985,SYC,82713502,45529878,-37183624
4158,1985,SYR,3442988472,1455761575,-1987226897
4159,1985,TCA,16946360,4127888,-12818472
4160,1985,TCD,102772671,46173275,-56599396
4161,1985,TGO,345980509,184031705,-161948804
4162,1985,THA,8756126061,7456430174,-1299695887
4163,1985,TKL,85440,2516579,2431139
4164,1985,TLS,292738,9379197,9086459
4165,1985,TON,37667383,6159641,-31507742
4166,1985,TTO,1655126058,1967169380,312043322
4167,1985,TUN,2538225403,1594537575,-943687828
4168,1985,TUR,11078107920,8194420250,-2883687670
4169,1985,TUV,3816828,279754,-3537074
4170,1985,TWN,15490540070,31956957336,16466417266
4171,1985,TZA,669774983,352953397,-316821586
4172,1985,UGA,249027717,397576123,148548406
4173,1985,URY,715439277,1053903827,338464550
4174,1985,USA,3.38E+11,2.08E+11,-1.29E+11
4175,1985,VCT,30460819,58613835,28153016
4176,1985,VEN,6899885286,13961554886,7061669600
4177,1985,VGB,94087916,3125317,-90962599
4178,1985,VNM,467621651,292560869,-175060782
4179,1985,VUT,49809073,22687644,-27121429
4180,1985,WLF,3241582,62111,-3179471
4181,1985,WSM,46589566,23040727,-23548839
4182,1985,YEM,1094091760,80333289,-1013758471
4183,1985,ZAF,7923069576,10040868783,2117799207
4184,1985,ZMB,417201280,736402605,319201325
4185,1985,ZWE,642601870,1007582893,364981023
4186,1986,AGO,1044487624,1367748284,323260660
4187,1986,AIA,3025081,1907344,-1117737
4188,1986,ALB,89091126,122829672,33738546
4189,1986,AND,460011259,21291068,-438720191
4190,1986,ANT,867905718,869078396,1172678
4191,1986,ARE,6447097507,9017563108,2570465601
4192,1986,ARG,5060095290,7574126546,2514031256
4193,1986,ATG,87358863,4265567,-83093296
4194,1986,AUS,23487547215,21989178617,-1498368598
4195,1986,AUT,25743667867,21022007979,-4721659888
4196,1986,BDI,120258088,136878911,16620823
4197,1986,BEL,69353021394,67453995746,-1899025648
4198,1986,BEN,374626905,117836392,-256790513
4199,1986,BFA,246839116,44713407,-202125709
4200,1986,BGD,2379454288,1003239208,-1376215080
4201,1986,BGR,2951976309,1032356676,-1919619633
4202,1986,BHR,889927099,1116222530,226295431
4203,1986,BHS,1758136478,663668234,-1094468244
4204,1986,BLZ,101723057,85437409,-16285648
4205,1986,BMU,459506747,63699932,-395806815
4206,1986,BOL,753824782,576219461,-177605321
4207,1986,BRA,15553427242,25733354991,10179927749
4208,1986,BRB,417647653,172016544,-245631109
4209,1986,BRN,980719939,1840332717,859612778
4210,1986,BTN,14744054,1060745,-13683309
4211,1986,CAF,113673268,117526357,3853089
4212,1986,CAN,71847874730,85955729942,14107855212
4213,1986,CCK,5011712,3965353,-1046359
4214,1986,CHE,41737852434,38258405203,-3479447231
4215,1986,CHL,3210297331,4344568336,1134271005
4216,1986,CHN,32800875545,29594184154,-3206691391
4217,1986,CIV,1410813576,2809694080,1398880504
4218,1986,CMR,1653093314,1882682653,229589339
4219,1986,COD,1099486211,1587549363,488063152
4220,1986,COG,558291044,817623304,259332260
4221,1986,COK,20771380,5264974,-15506406
4222,1986,COL,3692156961,5463451841,1771294880
4223,1986,COM,58506031,29507163,-28998868
4224,1986,CPV,105518834,6927023,-98591811
4225,1986,CRI,1147721046,1418512696,270791650
4226,1986,CUB,1616894873,626496131,-990398742
4227,1986,CXR,2489272,24442810,21953538
4228,1986,CYM,120997895,17678922,-103318973
4229,1986,CYP,1574154825,570424012,-1003730813
4230,1986,DEU,1.74E+11,2.32E+11,57963043252
4231,1986,DJI,232363008,10698628,-221664380
4232,1986,DMA,76111170,49332108,-26779062
4233,1986,DNK,21675152561,19762767407,-1912385154
4234,1986,DOM,1571103926,1201621910,-369482016
4235,1986,DZA,8201782525,9613843644,1412061119
4236,1986,ECU,1918902535,2618778484,699875949
4237,1986,EGY,9469520231,3329612191,-6139908040
4238,1986,ESH,656343,991273,334930
4239,1986,ESP,34914426561,27059594188,-7854832373
4240,1986,ETH,987833896,458216676,-529617220
4241,1986,FIN,12681551522,12960588825,279037303
4242,1986,FJI,367126265,222122588,-145003677
4243,1986,FLK,22425070,24755045,2329975
4244,1986,FRA,1.27E+11,1.16E+11,-11258458363
4245,1986,FRO,371982950,233817899,-138165051
4246,1986,GAB,781847700,1135413983,353566283
4247,1986,GBR,1.16E+11,1.05E+11,-11309497444
4248,1986,GHA,600818513,698255365,97436852
4249,1986,GIB,226060690,19692661,-206368029
4250,1986,GIN,305526812,405399542,99872730
4251,1986,GMB,132311914,29829065,-102482849
4252,1986,GNB,71380645,15598645,-55782000
4253,1986,GNQ,29619094,39028164,9409070
4254,1986,GRC,10873264322,5870618304,-5002646018
4255,1986,GRD,76432639,21402010,-55030629
4256,1986,GRL,328355511,352450209,24094698
4257,1986,GTM,947990693,1335061589,387070896
4258,1986,GUY,152988893,241456101,88467208
4259,1986,HKG,34822107018,33405918197,-1416188821
4260,1986,HND,788100248,910882038,122781790
4261,1986,HTI,532918385,469300321,-63618064
4262,1986,HUN,4030304873,3572836421,-457468452
4263,1986,IDN,10003221734,16173341014,6170119280
4264,1986,IND,15225557056,8652919831,-6572637225
4265,1986,IOT,2747894,2814560,66666
4266,1986,IRL,11169641339,12372424422,1202783083
4267,1986,IRN,7355087962,7046391946,-308696016
4268,1986,IRQ,6236911709,6739053496,502141787
4269,1986,ISL,1005055625,1073104993,68049368
4270,1986,ISR,8322534672,6321848112,-2000686560
4271,1986,ITA,89558001680,93588832722,4030831042
4272,1986,JAM,932533995,688220784,-244313211
4273,1986,JOR,2557938034,833726594,-1724211440
4274,1986,JPN,1.11E+11,2.07E+11,96253428400
4275,1986,KEN,1708111690,1337714339,-370397351
4276,1986,KHM,9085083,3825617,-5259466
4277,1986,KIR,18522462,2104914,-16417548
4278,1986,KNA,311486774,94543052,-216943722
4279,1986,KOR,28212100006,32351098009,4138998003
4280,1986,KWT,4736202294,6042170796,1305968502
4281,1986,LAO,52377894,5382291,-46995603
4282,1986,LBN,1610480758,358054074,-1252426684
4283,1986,LBR,1939449165,818918383,-1120530782
4284,1986,LBY,3960054731,6950762018,2990707287
4285,1986,LCA,128689662,94245974,-34443688
4286,1986,LKA,1905176024,1288286734,-616889290
4287,1986,MAC,550980620,1228155259,677174639
4288,1986,MAR,3790375440,2745200370,-1045175070
4289,1986,MDG,300605324,372523446,71918122
4290,1986,MDV,69982010,40956299,-29025711
4291,1986,MEX,16674659026,23626863394,6952204368
4292,1986,MLI,284525250,93374239,-191151011
4293,1986,MLT,840111345,411847629,-428263716
4294,1986,MMR,464284262,313526087,-150758175
4295,1986,MNG,20477080,31792343,11315263
4296,1986,MOZ,358728443,113763904,-244964539
4297,1986,MRT,353541446,365256240,11714794
4298,1986,MSR,88586789,9062860,-79523929
4299,1986,MUS,675814070,647342309,-28471761
4300,1986,MWI,210683666,279000848,68317182
4301,1986,MYS,11113182811,15743477452,4630294641
4302,1986,NCL,430872658,209502766,-221369892
4303,1986,NER,190175675,238703073,48527398
4304,1986,NGA,4188742691,7917494244,3728751553
4305,1986,NIC,415708104,294023054,-121685050
4306,1986,NIU,3352994,451015,-2901979
4307,1986,NLD,82087072136,74327375962,-7759696174
4308,1986,NOR,19590936238,18078677639,-1512258599
4309,1986,NPL,285302066,156027862,-129274204
4310,1986,NRU,26485637,83402761,56917124
4311,1986,NZL,5249588343,6006481632,756893289
4312,1986,OMN,2330989811,2543347404,212357593
4313,1986,PAK,5601856431,3366594463,-2235261968
4314,1986,PAN,6588402687,1523435155,-5064967532
4315,1986,PCN,1623302,946274,-677028
4316,1986,PER,2525614858,2538589389,12974531
4317,1986,PHL,5710822021,5746809188,35987167
4318,1986,PNG,828624511,1021794626,193170115
4319,1986,POL,4856698876,5784198485,927499609
4320,1986,PRK,490853494,375831295,-115022199
4321,1986,PRT,8848579815,7193147741,-1655432074
4322,1986,PRY,996389990,479594752,-516795238
4323,1986,PYF,424594069,19704196,-404889873
4324,1986,QAT,871133008,1998030346,1126897338
4325,1986,REU,980046167,126879496,-853166671
4326,1986,ROU,2803552064,4600816006,1797263942
4327,1986,RWA,176701461,175877147,-824314
4328,1986,SAU,20015188013,23081083521,3065895508
4329,1986,SDN,899032184,360183089,-538849095
4330,1986,SEN,926549781,522805795,-403743986
4331,1986,SGP,25383635936,22056853713,-3326782223
4332,1986,SHN,13955909,4133452,-9822457
4333,1986,SLB,74915166,99788807,24873641
4334,1986,SLE,138495214,141501823,3006609
4335,1986,SLV,1029853737,806956934,-222896803
4336,1986,SOM,304288543,98180703,-206107840
4337,1986,SPM,40522217,16466184,-24056033
4338,1986,STP,11543147,6513260,-5029887
4339,1986,SUR,211591721,322144877,110553156
4340,1986,SWE,30975901361,36278637788,5302736427
4341,1986,SYC,92060630,65211353,-26849277
4342,1986,SYR,2254406961,828714159,-1425692802
4343,1986,TCA,19096515,5239886,-13856629
4344,1986,TCD,95080197,50027676,-45052521
4345,1986,TGO,455120832,269570040,-185550792
4346,1986,THA,8763587882,9261629625,498041743
4347,1986,TKL,28717,375250,346533
4348,1986,TLS,906909,13314388,12407479
4349,1986,TON,33433297,4901082,-28532215
4350,1986,TTO,1255679355,1326410062,70730707
4351,1986,TUN,2751389038,1824760273,-926628765
4352,1986,TUR,10406592509,7586183812,-2820408697
4353,1986,TUV,3284934,272492,-3012442
4354,1986,TWN,20337841899,39491327596,19153485697
4355,1986,TZA,704558639,405215667,-299342972
4356,1986,UGA,291296239,440230513,148934274
4357,1986,URY,1010115104,1279186825,269071721
4358,1986,USA,3.64E+11,2.15E+11,-1.50E+11
4359,1986,VCT,43884061,55720945,11836884
4360,1986,VEN,7109694430,8512823305,1403128875
4361,1986,VGB,61344819,580974,-60763845
4362,1986,VNM,440887232,270279227,-170608005
4363,1986,VUT,54378106,13769305,-40608801
4364,1986,WLF,4555987,83306,-4472681
4365,1986,WSM,38978982,12339465,-26639517
4366,1986,YEM,911294805,42623399,-868671406
4367,1986,ZAF,8537990451,11122390757,2584400306
4368,1986,ZMB,400346083,709053109,308707026
4369,1986,ZWE,767006400,1197727162,430720762
4370,1987,AGO,1023598919,2066101785,1042502866
4371,1987,AIA,3109539,328123,-2781416
4372,1987,ALB,99791229,119709101,19917872
4373,1987,AND,639162435,24411605,-614750830
4374,1987,ANT,1293151014,816844388,-476306626
4375,1987,ARE,6627669001,10795029406,4167360405
4376,1987,ARG,5930186809,6707739503,777552694
4377,1987,ATG,81242038,7427601,-73814437
4378,1987,AUS,26288231982,26054422634,-233809348
4379,1987,AUT,31864461063,25740572897,-6123888166
4380,1987,BDI,143878001,107268276,-36609725
4381,1987,BEL,84243526465,81676949443,-2566577022
4382,1987,BEN,443813642,106705745,-337107897
4383,1987,BFA,239543587,69884711,-169658876
4384,1987,BGD,2645146300,1228694663,-1416451637
4385,1987,BGR,3164182687,1125494900,-2038687787
4386,1987,BHR,945442480,1114474408,169031928
4387,1987,BHS,2019814394,693295541,-1326518853
4388,1987,BLZ,142398320,96286622,-46111698
4389,1987,BMU,533032672,417440474,-115592198
4390,1987,BOL,841578073,544323062,-297255011
4391,1987,BRA,16794629336,29599930475,12805301139
4392,1987,BRB,402918213,139962082,-262956131
4393,1987,BRN,1108615405,1817952976,709337571
4394,1987,BTN,11111313,1532511,-9578802
4395,1987,CAF,104280050,84796762,-19483288
4396,1987,CAN,85586106219,93752160086,8166053867
4397,1987,CCK,14051037,1619351,-12431686
4398,1987,CHE,51655437135,45468267831,-6187169304
4399,1987,CHL,3827893310,5177940221,1350046911
4400,1987,CHN,40272841899,43496725960,3223884061
4401,1987,CIV,1571602533,2627884371,1056281838
4402,1987,CMR,1592761342,1971131991,378370649
4403,1987,COD,1126082810,1688898702,562815892
4404,1987,COG,457084154,958543553,501459399
4405,1987,COK,29835117,7386857,-22448260
4406,1987,COL,3971308568,5483833069,1512524501
4407,1987,COM,85464268,38778712,-46685556
4408,1987,CPV,99973158,11107644,-88865514
4409,1987,CRI,1404572891,1438940808,34367917
4410,1987,CUB,1255478171,711330254,-544147917
4411,1987,CXR,3723429,30055029,26331600
4412,1987,CYM,288912717,37832357,-251080360
4413,1987,CYP,1873343981,707933602,-1165410379
4414,1987,DEU,2.09E+11,2.80E+11,70962762924
4415,1987,DJI,266026498,17205323,-248821175
4416,1987,DMA,113582119,68629074,-44953045
4417,1987,DNK,24314336419,23808011258,-506325161
4418,1987,DOM,2223514659,1295527782,-927986877
4419,1987,DZA,6798539237,9971168385,3172629148
4420,1987,ECU,1942141562,2374496343,432354781
4421,1987,EGY,8856498335,3993307367,-4863190968
4422,1987,ESH,636086,565835,-70251
4423,1987,ESP,47885942781,33334855062,-14551087719
4424,1987,ETH,984614685,408654183,-575960502
4425,1987,FIN,15898735302,16617776692,719041390
4426,1987,FJI,322496413,251136796,-71359617
4427,1987,FLK,17038294,18719941,1681647
4428,1987,FRA,1.57E+11,1.39E+11,-18580803441
4429,1987,FRO,469395062,285712449,-183682613
4430,1987,GAB,669488100,1289601828,620113728
4431,1987,GBR,1.43E+11,1.26E+11,-16643224241
4432,1987,GHA,741510349,889333536,147823187
4433,1987,GIB,245362079,17874629,-227487450
4434,1987,GIN,359867430,483775882,123908452
4435,1987,GMB,148266423,58709498,-89556925
4436,1987,GNB,81969681,16498930,-65470751
4437,1987,GNQ,52661096,37715030,-14946066
4438,1987,GRC,12396111124,7019945731,-5376165393
4439,1987,GRD,89327342,26144523,-63182819
4440,1987,GRL,483840990,492564072,8723082
4441,1987,GTM,1320901449,1191898779,-129002670
4442,1987,GUY,140240430,263264215,123023785
4443,1987,HKG,47137510508,47696310437,558799929
4444,1987,HND,887592462,989719531,102127069
4445,1987,HTI,645258940,450471237,-194787703
4446,1987,HUN,4521602410,4320382938,-201219472
4447,1987,IDN,11058268951,18876769731,7818500780
4448,1987,IND,16498009611,10642058798,-5855950813
4449,1987,IOT,1665537,2144858,479321
4450,1987,IRL,13355783676,15938812533,2583028857
4451,1987,IRN,7160693827,10275008744,3114314917
4452,1987,IRQ,4971126276,9335578671,4364452395
4453,1987,ISL,1376708105,1356110712,-20597393
4454,1987,ISR,10242671182,7498686718,-2743984464
4455,1987,ITA,1.10E+11,1.12E+11,2183049217
4456,1987,JAM,1234986372,839627199,-395359173
4457,1987,JOR,3294049949,1052520541,-2241529408
4458,1987,JPN,1.36E+11,2.29E+11,93291136223
4459,1987,KEN,1821203930,1125512524,-695691406
4460,1987,KHM,8567496,8549531,-17965
4461,1987,KIR,16688560,2340517,-14348043
4462,1987,KNA,310171174,97948337,-212222837
4463,1987,KOR,36757299153,44597924080,7840624927
4464,1987,KWT,4982427771,8059575521,3077147750
4465,1987,LAO,71733447,24734553,-46998894
4466,1987,LBN,1362158181,407297969,-954860212
4467,1987,LBR,1989730863,954720625,-1035010238
4468,1987,LBY,4383880869,7381370217,2997489348
4469,1987,LCA,160124265,83596649,-76527616
4470,1987,LKA,2016173048,1501576172,-514596876
4471,1987,MAC,1138716171,1628813448,490097277
4472,1987,MAR,4318802193,3222026424,-1096775769
4473,1987,MDG,282927966,369486276,86558310
4474,1987,MDV,92972908,38815955,-54156953
4475,1987,MEX,19375188710,29089295515,9714106805
4476,1987,MLI,393235713,105086465,-288149248
4477,1987,MLT,1163731917,536721137,-627010780
4478,1987,MMR,495236526,387030707,-108205819
4479,1987,MNG,45142953,49183611,4040658
4480,1987,MOZ,540742735,221062498,-319680237
4481,1987,MRT,440471826,393427367,-47044459
4482,1987,MSR,69956179,7229329,-62726850
4483,1987,MUS,979464303,837483668,-141980635
4484,1987,MWI,247859967,337691403,89831436
4485,1987,MYS,13198765868,20511559490,7312793622
4486,1987,NCL,528240523,186470845,-341769678
4487,1987,NER,215355434,391596022,176240588
4488,1987,NGA,4103967179,7665636801,3561669622
4489,1987,NIC,307951770,192317716,-115634054
4490,1987,NIU,3969277,461586,-3507691
4491,1987,NLD,99000868658,86755151816,-12245716842
4492,1987,NOR,22049702289,21194483604,-855218685
4493,1987,NPL,471068164,161034071,-310034093
4494,1987,NRU,22230193,64529608,42299415
4495,1987,NZL,6488739140,7031734274,542995134
4496,1987,OMN,1998910503,3485843095,1486932592
4497,1987,PAK,6103538495,3880586301,-2222952194
4498,1987,PAN,6016970229,1784512029,-4232458200
4499,1987,PCN,1730134,597796,-1132338
4500,1987,PER,3074636560,2685839990,-388796570
4501,1987,PHL,7685970895,6693125034,-992845861
4502,1987,PNG,1020209547,1179040128,158830581
4503,1987,POL,5471317059,6537273952,1065956893
4504,1987,PRK,861192702,768761867,-92430835
4505,1987,PRT,13066920725,9176465613,-3890455112
4506,1987,PRY,1014667741,588017815,-426649926
4507,1987,PYF,521278632,27225479,-494053153
4508,1987,QAT,881125851,1875423582,994297731
4509,1987,REU,1313921209,154667753,-1159253456
4510,1987,ROU,2351243752,5232556680,2881312928
4511,1987,RWA,211995174,135255851,-76739323
4512,1987,SAU,20136292488,25033403013,4897110525
4513,1987,SDN,940024827,480229825,-459795002
4514,1987,SEN,1011595650,559719819,-451875831
4515,1987,SGP,32084954293,27429706462,-4655247831
4516,1987,SHN,22333756,4839077,-17494679
4517,1987,SLB,81091788,68520913,-12570875
4518,1987,SLE,144219177,153552322,9333145
4519,1987,SLV,996765829,651351050,-345414779
4520,1987,SOM,352271162,113769697,-238501465
4521,1987,SPM,46326875,28681598,-17645277
4522,1987,STP,13650111,4398190,-9251921
4523,1987,SUR,210004379,350882548,140878169
4524,1987,SWE,38451496726,43336297190,4884800464
4525,1987,SYC,112014993,69692363,-42322630
4526,1987,SYR,2076147035,790097186,-1286049849
4527,1987,TCA,16971511,4891354,-12080157
4528,1987,TCD,111860830,51861838,-59998992
4529,1987,TGO,506025295,246143609,-259881686
4530,1987,THA,11977673680,12032899639,55225959
4531,1987,TKL,94269,93366,-903
4532,1987,TLS,1824765,14338650,12513885
4533,1987,TON,44703785,5637961,-39065824
4534,1987,TTO,942905658,1404908207,462002549
4535,1987,TUN,2946269928,2234852983,-711416945
4536,1987,TUR,13697384580,10155603577,-3541781003
4537,1987,TUV,4104404,314312,-3790092
4538,1987,TWN,29569549523,53731398398,24161848875
4539,1987,TZA,827578403,345739186,-481839217
4540,1987,UGA,396804580,314848568,-81956012
4541,1987,URY,1236335072,1378367333,142032261
4542,1987,USA,4.10E+11,2.51E+11,-1.59E+11
4543,1987,VCT,48692392,52513839,3821447
4544,1987,VEN,8459450748,9387400331,927949583
4545,1987,VGB,65115147,2326533,-62788614
4546,1987,VNM,437789389,352862299,-84927090
4547,1987,VUT,75251615,14340419,-60911196
4548,1987,WLF,3878973,100814,-3778159
4549,1987,WSM,50673328,13801739,-36871589
4550,1987,YEM,781867978,63847248,-718020730
4551,1987,ZAF,10412747286,10456847499,44100213
4552,1987,ZMB,391948078,870201721,478253643
4553,1987,ZWE,466140810,1095110666,628969856
4554,1988,ABW,34805807,362389,-34443418
4555,1988,AGO,1263058587,2493312352,1230253765
4556,1988,AIA,40575987,1163037,-39412950
4557,1988,ALB,157369144,158811660,1442516
4558,1988,AND,807618553,35328653,-772289900
4559,1988,ANT,1320369965,683994252,-636375713
4560,1988,ARE,8218398792,10535619365,2317220573
4561,1988,ARG,5237407291,9827291314,4589884023
4562,1988,ATG,170526821,33532109,-136994712
4563,1988,AUS,32222083983,31908900245,-313183738
4564,1988,AUT,36185743142,29152855768,-7032887374
4565,1988,BDI,141972186,142950129,977943
4566,1988,BEL,96225899589,88073330151,-8152569438
4567,1988,BEN,342825810,65811662,-277014148
4568,1988,BFA,258385619,102606476,-155779143
4569,1988,BGD,2962801614,1364577102,-1598224512
4570,1988,BGR,3041157701,1216402983,-1824754718
4571,1988,BHR,1172599552,1270412852,97813300
4572,1988,BHS,1526490486,791620624,-734869862
4573,1988,BLZ,185273777,117586287,-67687490
4574,1988,BMU,858225596,627685675,-230539921
4575,1988,BOL,728507672,557366890,-171140782
4576,1988,BRA,16694021608,37248246905,20554225297
4577,1988,BRB,451100181,125498213,-325601968
4578,1988,BRN,1140863195,1864474090,723610895
4579,1988,BTN,10944880,3228176,-7716704
4580,1988,CAF,117687450,97675381,-20012069
4581,1988,CAN,1.01E+11,1.11E+11,9841006900
4582,1988,CCK,7524225,1359614,-6164611
4583,1988,CHE,58019498144,51711220498,-6308277646
4584,1988,CHL,4824743713,7189690550,2364946837
4585,1988,CHN,51993634129,56091348521,4097714392
4586,1988,CIV,1501662566,2255182848,753520282
4587,1988,CMR,1000738816,1586861062,586122246
4588,1988,COD,1223230039,1663800528,440570489
4589,1988,COG,443495374,918067110,474571736
4590,1988,COK,32880291,24658314,-8221977
4591,1988,COL,4805055584,5573669933,768614349
4592,1988,COM,64121656,26092134,-38029522
4593,1988,CPV,120802190,3896713,-116905477
4594,1988,CRI,1517964303,1675471576,157507273
4595,1988,CUB,1564010884,1014738484,-549272400
4596,1988,CXR,1591749,6376581,4784832
4597,1988,CYM,205764362,67388545,-138375817
4598,1988,CYP,2233454201,867176224,-1366277977
4599,1988,DEU,2.36E+11,3.16E+11,79713095166
4600,1988,DJI,236697136,19915867,-216781269
4601,1988,DMA,64787724,86977870,22190146
4602,1988,DNK,26015556966,26066400942,50843976
4603,1988,DOM,2207901419,1677785731,-530115688
4604,1988,DZA,7142482206,8738977451,1596495245
4605,1988,ECU,1893881032,2635974951,742093919
4606,1988,EGY,9863934571,3493042937,-6370891634
4607,1988,ESH,131684,261367,129683
4608,1988,ESP,57630140252,39788924777,-17841215475
4609,1988,ETH,1198221341,394728286,-803493055
4610,1988,FIN,18173004423,18597448957,424444534
4611,1988,FJI,388546522,301078133,-87468389
4612,1988,FLK,22237334,31277449,9040115
4613,1988,FRA,1.77E+11,1.59E+11,-18265349579
4614,1988,FRO,433335730,341039906,-92295824
4615,1988,GAB,758669175,1206307071,447637896
4616,1988,GBR,1.71E+11,1.34E+11,-36490159138
4617,1988,GHA,790079750,905981429,115901679
4618,1988,GIB,342449168,29506012,-312943156
4619,1988,GIN,376291055,487050841,110759786
4620,1988,GMB,162351733,95091221,-67260512
4621,1988,GNB,70375622,13093774,-57281848
4622,1988,GNQ,50278034,45984611,-4293423
4623,1988,GRC,14045872073,7503407247,-6542464826
4624,1988,GRD,96894986,34881299,-62013687
4625,1988,GRL,518009975,554837105,36827130
4626,1988,GTM,1445070206,1416990735,-28079471
4627,1988,GUY,145426779,235583022,90156243
4628,1988,HKG,63513989575,62927385271,-586604304
4629,1988,HND,934790238,972074213,37283975
4630,1988,HTI,696537255,444493602,-252043653
4631,1988,HUN,4635273221,4856984974,221711753
4632,1988,IDN,12438529325,21001825873,8563296548
4633,1988,IND,19306785171,12633379792,-6673405379
4634,1988,IOT,5318053,2104238,-3213815
4635,1988,IRL,15195650732,18444299721,3248648989
4636,1988,IRN,6666747625,7114503031,447755406
4637,1988,IRQ,7079183886,9083773786,2004589900
4638,1988,ISL,1301050575,1360801734,59751159
4639,1988,ISR,11556012578,9069701713,-2486310865
4640,1988,ITA,1.25E+11,1.23E+11,-1407817621
4641,1988,JAM,1457943865,940254283,-517689582
4642,1988,JOR,3243118635,1045495516,-2197623119
4643,1988,JPN,1.70E+11,2.64E+11,93985817728
4644,1988,KEN,1970547803,1161913412,-808634391
4645,1988,KHM,11897770,6105124,-5792646
4646,1988,KIR,21025373,11738724,-9286649
4647,1988,KNA,79181472,29505797,-49675675
4648,1988,KOR,45516456914,58014824245,12498367331
4649,1988,KWT,5448587428,6527322564,1078735136
4650,1988,LAO,34088823,52102091,18013268
4651,1988,LBN,1862218818,590555378,-1271663440
4652,1988,LBR,2105440874,1470892929,-634547945
4653,1988,LBY,5606043044,6984434455,1378391411
4654,1988,LCA,190329388,150883399,-39445989
4655,1988,LKA,2328710863,1662133045,-666577818
4656,1988,MAC,1281885239,1756451667,474566428
4657,1988,MAR,4987979995,4137476307,-850503688
4658,1988,MDG,306621948,337295346,30673398
4659,1988,MDV,105175660,63252381,-41923279
4660,1988,MEX,27109345154,31560173925,4450828771
4661,1988,MLI,299483155,104878171,-194604984
4662,1988,MLT,1236010459,740106889,-495903570
4663,1988,MMR,560330584,417735147,-142595437
4664,1988,MNG,46113330,54641209,8527879
4665,1988,MOZ,551137244,312683593,-238453651
4666,1988,MRT,424204558,421785194,-2419364
4667,1988,MSR,17043882,3255921,-13787961
4668,1988,MUS,1053198450,1003645511,-49552939
4669,1988,MWI,332387749,309390499,-22997250
4670,1988,MYS,17716886140,25140726621,7423840481
4671,1988,NCL,515487282,493814537,-21672745
4672,1988,NER,257588737,355978687,98389950
4673,1988,NGA,3952661651,7243470998,3290809347
4674,1988,NIC,458053367,256479797,-201573570
4675,1988,NIU,3513475,794979,-2718496
4676,1988,NLD,1.12E+11,99698424234,-12528885983
4677,1988,NOR,22419855689,22210197014,-209658675
4678,1988,NPL,464819911,211611951,-253207960
4679,1988,NRU,23486270,77726924,54240654
4680,1988,NZL,6319012746,8701408466,2382395720
4681,1988,OMN,2252435272,3026017994,773582722
4682,1988,PAK,6907718669,4309477879,-2598240790
4683,1988,PAN,5572452241,2032890863,-3539561378
4684,1988,PCN,3036454,1873712,-1162742
4685,1988,PER,2541924252,3066214600,524290348
4686,1988,PHL,9237825212,8154356173,-1083469039
4687,1988,PNG,1246685046,1341842319,95157273
4688,1988,POL,6740559348,7365462949,624903601
4689,1988,PRK,1060751244,867181649,-193569595
4690,1988,PRT,16795753847,10834954169,-5960799678
4691,1988,PRY,1004634361,875772625,-128861736
4692,1988,PYF,568876029,43605744,-525270285
4693,1988,QAT,1133915269,2056493340,922578071
4694,1988,REU,1491645808,163255690,-1328390118
4695,1988,ROU,2001973137,5334296234,3332323097
4696,1988,RWA,206066211,162860458,-43205753
4697,1988,SAU,21950673436,26245524478,4294851042
4698,1988,SDN,1179671009,573841938,-605829071
4699,1988,SEN,895456751,528749567,-366707184
4700,1988,SGP,41862909744,37465916788,-4396992956
4701,1988,SHN,18712557,8281979,-10430578
4702,1988,SLB,102103331,78825706,-23277625
4703,1988,SLE,141114774,189359693,48244919
4704,1988,SLV,1135838059,712250208,-423587851
4705,1988,SOM,205840182,108980038,-96860144
4706,1988,SPM,47605015,12170969,-35434046
4707,1988,STP,32799869,16252262,-16547607
4708,1988,SUR,271550237,375907555,104357318
4709,1988,SWE,41747456526,48304363431,6556906905
4710,1988,SYC,134577675,135565074,987399
4711,1988,SYR,1386765933,620722152,-766043781
4712,1988,TCA,37572053,3827688,-33744365
4713,1988,TCD,90707491,58424952,-32282539
4714,1988,TGO,551363770,260682843,-290680927
4715,1988,THA,17325328529,14540424967,-2784903562
4716,1988,TKL,3046263,4623352,1577089
4717,1988,TLS,200467,414445,213978
4718,1988,TON,49677643,6275223,-43402420
4719,1988,TTO,906630510,1339683474,433052964
4720,1988,TUN,3461225648,2383465032,-1077760616
4721,1988,TUR,13752702221,11804618424,-1948083797
4722,1988,TUV,4532269,611804,-3920465
4723,1988,TWN,40270822098,62109395320,21838573222
4724,1988,TZA,790791320,374412512,-416378808
4725,1988,UGA,345218401,313431892,-31786509
4726,1988,URY,1329271021,1551474356,222203335
4727,1988,USA,4.45E+11,3.13E+11,-1.32E+11
4728,1988,VCT,94692934,109682901,14989967
4729,1988,VEN,10533629923,9088352819,-1445277104
4730,1988,VGB,70840938,13845837,-56995101
4731,1988,VNM,556553441,450014381,-106539060
4732,1988,VUT,198318873,23232485,-175086388
4733,1988,WLF,5735281,297974,-5437307
4734,1988,WSM,69173746,18115892,-51057854
4735,1988,YEM,1008114044,652585491,-355528553
4736,1988,ZAF,12737017705,12302136590,-434881115
4737,1988,ZMB,515797508,1088382346,572584838
4738,1988,ZWE,556759737,1107513388,550753651
4739,1989,ABW,94536048,7284872,-87251176
4740,1989,AGO,1406820257,2778212136,1371391879
4741,1989,AIA,104788041,10743416,-94044625
4742,1989,ALB,219494334,217270362,-2223972
4743,1989,AND,836478162,31525457,-804952705
4744,1989,ANT,2072971922,729927292,-1343044630
4745,1989,ARE,10026671020,13291891294,3265220274
4746,1989,ARG,4406110398,10771186175,6365075777
4747,1989,ATG,182188921,36981879,-145207042
4748,1989,AUS,38276509932,35936284216,-2340225716
4749,1989,AUT,38874631080,30609670000,-8264961080
4750,1989,BDI,121742951,112960354,-8782597
4751,1989,BEL,1.03E+11,99226073264,-3657256396
4752,1989,BEN,286211819,95820120,-190391699
4753,1989,BFA,267189058,106326336,-160862722
4754,1989,BGD,3350325064,1501643638,-1848681426
4755,1989,BGR,3204821143,1609795391,-1595025752
4756,1989,BHR,1615516445,1331764737,-283751708
4757,1989,BHS,1438353075,1069426675,-368926400
4758,1989,BLZ,203457230,132929941,-70527289
4759,1989,BMU,788506093,660832113,-127673980
4760,1989,BOL,750965281,703545795,-47419486
4761,1989,BRA,20040906008,38358087548,18317181540
4762,1989,BRB,494856511,136280927,-358575584
4763,1989,BRN,1353631333,2050103704,696472371
4764,1989,BTN,16596510,3497980,-13098530
4765,1989,CAF,163099585,124811131,-38288454
4766,1989,CAN,1.12E+11,1.19E+11,6769355922
4767,1989,CCK,9863306,2587660,-7275646
4768,1989,CHE,62009452478,52430558891,-9578893587
4769,1989,CHL,6389037572,8623059540,2234021968
4770,1989,CHN,55882520515,69898009042,14015488527
4771,1989,CIV,1651868223,2286961554,635093331
4772,1989,CMR,1260492712,1970534585,710041873
4773,1989,COD,1283076289,1574663760,291587471
4774,1989,COG,483965304,1163052513,679087209
4775,1989,COK,26656513,6252013,-20404500
4776,1989,COL,5089513648,6021229374,931715726
4777,1989,COM,75200737,24024949,-51175788
4778,1989,CPV,126887243,11035000,-115852243
4779,1989,CRI,1886620661,1937902946,51282285
4780,1989,CUB,2052085238,1140268263,-911816975
4781,1989,CXR,2763249,2179282,-583967
4782,1989,CYM,374125719,101472442,-272653277
4783,1989,CYP,2709029404,1190012353,-1519017051
4784,1989,DEU,2.50E+11,3.33E+11,82605949961
4785,1989,DJI,247764530,14163522,-233601008
4786,1989,DMA,106490177,110953221,4463044
4787,1989,DNK,26433358577,25973849179,-459509398
4788,1989,DOM,2676246897,1936820844,-739426053
4789,1989,DZA,8651715525,9533874574,882159049
4790,1989,ECU,1878620866,2685557523,806936657
4791,1989,EGY,9697249724,4315838566,-5381411158
4792,1989,ESH,514213,1704615,1190402
4793,1989,ESP,67629622429,43066835467,-24562786962
4794,1989,ETH,894722426,452768637,-441953789
4795,1989,FIN,20861527340,19454964276,-1406563064
4796,1989,FJI,507830940,349028709,-158802231
4797,1989,FLK,24264993,14859886,-9405107
4798,1989,FRA,1.93E+11,1.70E+11,-22909840441
4799,1989,FRO,296203302,371097887,74894585
4800,1989,GAB,699238593,1641704808,942466215
4801,1989,GBR,1.82E+11,1.41E+11,-40747993251
4802,1989,GHA,927625331,869687581,-57937750
4803,1989,GIB,364613679,39441715,-325171964
4804,1989,GIN,431202238,567542929,136340691
4805,1989,GMB,157433736,138955540,-18478196
4806,1989,GNB,106654983,14435453,-92219530
4807,1989,GNQ,86194336,36295199,-49899137
4808,1989,GRC,16196194864,8283166668,-7913028196
4809,1989,GRD,92909917,33044018,-59865899
4810,1989,GRL,336134575,541504137,205369562
4811,1989,GTM,1789423799,1425071300,-364352499
4812,1989,GUY,176802633,240222245,63419612
4813,1989,HKG,71658188494,72759857177,1101668683
4814,1989,HND,1050717749,992765222,-57952527
4815,1989,HTI,712292877,437920501,-274372376
4816,1989,HUN,5452336296,5475763316,23427020
4817,1989,IDN,15182430083,24048813606,8866383523
4818,1989,IND,20270987457,14877075441,-5393912016
4819,1989,IOT,3735915,8883977,5148062
4820,1989,IRL,16938356293,20651283679,3712927386
4821,1989,IRN,7937734726,11521452530,3583717804
4822,1989,IRQ,7761656004,12240461261,4478805257
4823,1989,ISL,1139897671,1362069877,222172206
4824,1989,ISR,12020321717,9873845079,-2146476638
4825,1989,ITA,1.36E+11,1.35E+11,-1377736797
4826,1989,JAM,2091647800,1230439189,-861208611
4827,1989,JOR,2699569711,1144592070,-1554977641
4828,1989,JPN,1.94E+11,2.77E+11,82192298585
4829,1989,KEN,1687359404,962216141,-725143263
4830,1989,KHM,29977558,16510372,-13467186
4831,1989,KIR,35189485,7435145,-27754340
4832,1989,KNA,83814437,31580683,-52233754
4833,1989,KOR,54462298041,60172790415,5710492374
4834,1989,KWT,5779809370,9559022833,3779213463
4835,1989,LAO,104312380,77584641,-26727739
4836,1989,LBN,1836901507,425852741,-1411048766
4837,1989,LBR,2617077326,2387420448,-229656878
4838,1989,LBY,4760352503,7354561041,2594208538
4839,1989,LCA,213210625,126539736,-86670889
4840,1989,LKA,2394136933,1683475058,-710661875
4841,1989,MAC,1358265078,1835379415,477114337
4842,1989,MAR,5629940437,4146822643,-1483117794
4843,1989,MDG,317108771,345714749,28605978
4844,1989,MDV,126971279,66755299,-60215980
4845,1989,MEX,34350334685,35928684134,1578349449
4846,1989,MLI,430120296,293994606,-136125690
4847,1989,MLT,1423755430,827621354,-596134076
4848,1989,MMR,548322230,466841467,-81480763
4849,1989,MNG,63461224,81250986,17789762
4850,1989,MOZ,588173390,382333206,-205840184
4851,1989,MRT,430147148,481375827,51228679
4852,1989,MSR,26471281,3376508,-23094773
4853,1989,MUS,1105370599,987332567,-118038032
4854,1989,MWI,403594923,284056753,-119538170
4855,1989,MYS,21812592644,27564483831,5751891187
4856,1989,NCL,676650925,669170834,-7480091
4857,1989,NER,240511344,302188791,61677447
4858,1989,NGA,4208846634,10066453197,5857606563
4859,1989,NIC,387869998,295868518,-92001480
4860,1989,NIU,4034629,381448,-3653181
4861,1989,NLD,1.21E+11,1.05E+11,-16692366705
4862,1989,NOR,22596783779,26488865033,3892081254
4863,1989,NPL,439156237,219060623,-220095614
4864,1989,NRU,25954679,83060431,57105752
4865,1989,NZL,7794877386,8933901381,1139023995
4866,1989,OMN,2157779773,3929053457,1771273684
4867,1989,PAK,7245086558,4582962027,-2662124531
4868,1989,PAN,6376431064,2627415812,-3749015252
4869,1989,PCN,2050899,3426966,1376067
4870,1989,PER,2236466716,3624608590,1388141874
4871,1989,PHL,11849190174,8770394643,-3078795531
4872,1989,PNG,1392644937,1381698763,-10946174
4873,1989,POL,7961590116,8371039321,409449205
4874,1989,PRK,1061507456,766052300,-295455156
4875,1989,PRT,18888724338,12654943814,-6233780524
4876,1989,PRY,1133483184,1203411041,69927857
4877,1989,PYF,515684021,66662675,-449021346
4878,1989,QAT,1203858912,2527153515,1323294603
4879,1989,REU,1547473939,133709453,-1413764486
4880,1989,ROU,4833179236,7014580879,2181401643
4881,1989,RWA,163992106,104183322,-59808784
4882,1989,SAU,20328784134,30735949568,10407165434
4883,1989,SDN,1008188068,539598149,-468589919
4884,1989,SEN,1357023931,794297782,-562726149
4885,1989,SGP,46983396250,42908595312,-4074800938
4886,1989,SHN,20068674,5551758,-14516916
4887,1989,SLB,102400265,68073893,-34326372
4888,1989,SLE,193699118,239642530,45943412
4889,1989,SLV,1190818008,610961293,-579856715
4890,1989,SOM,289418224,99853393,-189564831
4891,1989,SPM,67701845,23615423,-44086422
4892,1989,STP,37710033,9810948,-27899085
4893,1989,SUR,340724197,476083097,135358900
4894,1989,SWE,45623475198,49899030985,4275555787
4895,1989,SYC,227195656,104548324,-122647332
4896,1989,SYR,1943100857,1904055263,-39045594
4897,1989,TCA,53128537,3416486,-49712051
4898,1989,TCD,148223810,72341837,-75881973
4899,1989,TGO,703422063,295926215,-407495848
4900,1989,THA,23323006988,20371399821,-2951607167
4901,1989,TKL,4718790,28834677,24115887
4902,1989,TLS,82816,192862,110046
4903,1989,TON,50228518,9244833,-40983685
4904,1989,TTO,1099768821,1477291583,377522762
4905,1989,TUN,4071339678,2960930381,-1110409297
4906,1989,TUR,14557780496,12009942534,-2547837962
4907,1989,TUV,5693708,458587,-5235121
4908,1989,TWN,48792336413,68404106454,19611770041
4909,1989,TZA,802858785,448438128,-354420657
4910,1989,UGA,310726203,281258689,-29467514
4911,1989,URY,1461932343,1855181483,393249140
4912,1989,USA,4.79E+11,3.58E+11,-1.21E+11
4913,1989,VCT,145583901,96551212,-49032689
4914,1989,VEN,6666916126,12459831214,5792915088
4915,1989,VGB,101473509,15678568,-85794941
4916,1989,VNM,637439913,942773754,305333841
4917,1989,VUT,216534056,63209058,-153324998
4918,1989,WLF,5996968,92034,-5904934
4919,1989,WSM,54554049,19143712,-35410337
4920,1989,YEM,964067215,1050527959,86460744
4921,1989,ZAF,12137133756,13583660482,1446526726
4922,1989,ZMB,625862204,1251873573,626011369
4923,1989,ZWE,726917667,1265997273,539079606
4924,1990,ABW,299413972,43474766,-255939206
4925,1990,AGO,1537435004,3712688619,2175253615
4926,1990,AIA,105214839,2501727,-102713112
4927,1990,ALB,240667693,174189237,-66478456
4928,1990,AND,1068386691,39991614,-1028395077
4929,1990,ANT,1780354946,901855109,-878499837
4930,1990,ARE,11835890625,18454321463,6618430838
4931,1990,ARG,4755628503,13488931545,8733303042
4932,1990,ATG,171165706,26218678,-144947028
4933,1990,AUS,36980577320,38425395509,1444818189
4934,1990,AUT,47582309687,39040892215,-8541417472
4935,1990,BDI,165260983,91542599,-73718384
4936,1990,BEL,1.25E+11,1.16E+11,-8347773422
4937,1990,BEN,379384881,101067791,-278317090
4938,1990,BFA,306725369,125917937,-180807432
4939,1990,BGD,3630912809,1790062614,-1840850195
4940,1990,BGR,2299090714,1567166822,-731923892
4941,1990,BHR,1717168414,1630227917,-86940497
4942,1990,BHS,2069104609,1018854660,-1050249949
4943,1990,BLZ,208397044,124778782,-83618262
4944,1990,BMU,837788555,692491466,-145297089
4945,1990,BOL,741283639,736967381,-4316258
4946,1990,BRA,21862303268,34909497197,13047193929
4947,1990,BRB,547918471,133838129,-414080342
4948,1990,BRN,1551619726,2361198143,809578417
4949,1990,BTN,14073936,2712249,-11361687
4950,1990,CAF,156038468,131327718,-24710750
4951,1990,CAN,1.17E+11,1.26E+11,8846956013
4952,1990,CCK,18702640,3434816,-15267824
4953,1990,CHE,72107006817,64182143850,-7924862967
4954,1990,CHL,6941684797,9088572288,2146887491
4955,1990,CHN,52566871878,83621094141,31054222263
4956,1990,CIV,1368820655,2702406164,1333585509
4957,1990,CMR,1382270885,2359624073,977353188
4958,1990,COD,1281946438,1842992488,561046050
4959,1990,COG,643908116,1193195972,549287856
4960,1990,COK,38613548,7880278,-30733270
4961,1990,COL,5274394011,7036724880,1762330869
4962,1990,COM,83530358,24671429,-58858929
4963,1990,CPV,126434908,14600653,-111834255
4964,1990,CRI,2068304557,2092176688,23872131
4965,1990,CUB,2327156952,1298477684,-1028679268
4966,1990,CXR,4465949,3535883,-930066
4967,1990,CYM,436641600,67344379,-369297221
4968,1990,CYP,3064488315,1058393950,-2006094365
4969,1990,DEU,3.19E+11,3.88E+11,68222443566
4970,1990,DJI,309978890,21056985,-288921905
4971,1990,DMA,98187459,99181700,994241
4972,1990,DNK,31171434502,32297262854,1125828352
4973,1990,DOM,2780925004,1963376322,-817548682
4974,1990,DZA,9361575339,12884702497,3523127158
4975,1990,ECU,1911606183,3146827006,1235220823
4976,1990,EGY,11013957154,4825727926,-6188229228
4977,1990,ESH,2759569,342222,-2417347
4978,1990,ESP,84663606276,53927702648,-30735903628
4979,1990,ETH,970654136,330499040,-640155096
4980,1990,FIN,23284043526,22600405646,-683637880
4981,1990,FJI,612368674,396904464,-215464210
4982,1990,FLK,28817940,15046230,-13771710
4983,1990,FRA,2.36E+11,2.07E+11,-29181935165
4984,1990,FRO,285291997,414139751,128847754
4985,1990,GAB,725435365,2568114019,1842678654
4986,1990,GBR,2.03E+11,1.74E+11,-29232605638
4987,1990,GHA,1129490421,1083115331,-46375090
4988,1990,GIB,506208511,56282078,-449926433
4989,1990,GIN,479915108,628381937,148466829
4990,1990,GMB,190081622,166603624,-23477998
4991,1990,GNB,100158679,28862219,-71296460
4992,1990,GNQ,83945470,44749539,-39195931
4993,1990,GRC,18935971193,8756617633,-10179353560
4994,1990,GRD,99139815,32216985,-66922830
4995,1990,GRL,283191015,613006706,329815691
4996,1990,GTM,1842743749,1650055134,-192688615
4997,1990,GUY,202641667,254455128,51813461
4998,1990,HKG,82490576967,81806345432,-684231535
4999,1990,HND,1117104885,992185267,-124919618
5000,1990,HTI,690899129,398635704,-292263425
5001,1990,HUN,6117407578,6212119950,94712372
5002,1990,IDN,20327077977,27474491470,7147413493
5003,1990,IND,21039257460,16555243187,-4484014273
5004,1990,IOT,5162514,1822645,-3339869
5005,1990,IRL,20031417549,23588417751,3557000202
5006,1990,IRN,12439946930,15789953435,3350006505
5007,1990,IRQ,5276644055,10349165883,5072521828
5008,1990,ISL,1368217329,1583065735,214848406
5009,1990,ISR,13561715141,11482070057,-2079645084
5010,1990,ITA,1.61E+11,1.62E+11,548004386
5011,1990,JAM,1893320839,1396080067,-497240772
5012,1990,JOR,2803236498,1111879356,-1691357142
5013,1990,JPN,2.18E+11,2.90E+11,72132027552
5014,1990,KEN,2190223315,1459704944,-730518371
5015,1990,KHM,30762914,35422741,4659827
5016,1990,KIR,42739459,3327641,-39411818
5017,1990,KNA,101226218,24684458,-76541760
5018,1990,KOR,62053531366,61158030871,-895500495
5019,1990,KWT,3448520460,7085832313,3637311853
5020,1990,LAO,117597581,64907802,-52689779
5021,1990,LBN,2128957007,472537932,-1656419075
5022,1990,LBR,3661446584,2085937895,-1575508689
5023,1990,LBY,5229987572,11417939011,6187951439
5024,1990,LCA,220353346,157460293,-62893053
5025,1990,LKA,2808681987,2037361521,-771320466
5026,1990,MAC,1508348139,1977014329,468666190
5027,1990,MAR,7274502061,5372069782,-1902432279
5028,1990,MDG,583526126,368687642,-214838484
5029,1990,MDV,155807852,72234659,-83573193
5030,1990,MEX,40333572780,39996786172,-336786608
5031,1990,MLI,543434810,195877905,-347556905
5032,1990,MLT,1975050629,1068907333,-906143296
5033,1990,MMR,860933849,585342527,-275591322
5034,1990,MNG,93804684,58200287,-35604397
5035,1990,MOZ,720820615,416679187,-304141428
5036,1990,MRT,460529112,451313994,-9215118
5037,1990,MSR,64156748,4094005,-60062743
5038,1990,MUS,1439940180,1215180823,-224759357
5039,1990,MWI,496385794,369954924,-126430870
5040,1990,MYS,27436520730,31954063309,4517542579
5041,1990,NCL,714364352,438847416,-275516936
5042,1990,NER,238127761,285599825,47472064
5043,1990,NGA,5275486306,12792212192,7516725886
5044,1990,NIC,514412831,290776339,-223636492
5045,1990,NIU,9454525,406458,-9048067
5046,1990,NLD,1.44E+11,1.27E+11,-16455649974
5047,1990,NOR,25318427015,33535449427,8217022412
5048,1990,NPL,414911123,240789429,-174121694
5049,1990,NRU,36865648,59380321,22514673
5050,1990,NZL,8548977794,9367702286,818724492
5051,1990,OMN,2548832169,5073582163,2524749994
5052,1990,PAK,7525450099,5438510033,-2086940066
5053,1990,PAN,7364935169,2366071982,-4998863187
5054,1990,PCN,2008705,443428,-1565277
5055,1990,PER,2527401195,3552001165,1024599970
5056,1990,PHL,13589557530,9356210675,-4233346855
5057,1990,PNG,1158201132,1058979919,-99221213
5058,1990,POL,8812463692,11033219232,2220755540
5059,1990,PRK,992514940,726252759,-266262181
5060,1990,PRT,23838311895,16279679547,-7558632348
5061,1990,PRY,1832272455,1244417194,-587855261
5062,1990,PYF,639759574,74349306,-565410268
5063,1990,QAT,1312006500,3300944848,1988938348
5064,1990,REU,1821349256,141395468,-1679953788
5065,1990,ROU,6043874051,4140698190,-1903175861
5066,1990,RWA,223665231,166614275,-57050956
5067,1990,SAU,23552929030,45119633692,21566704662
5068,1990,SDN,857938644,482712428,-375226216
5069,1990,SEN,1462737472,787712376,-675025096
5070,1990,SGP,57099479107,50458962259,-6640516848
5071,1990,SHN,19623579,5828950,-13794629
5072,1990,SLB,86031283,82107371,-3923912
5073,1990,SLE,182804174,215307631,32503457
5074,1990,SLV,1209310885,597971048,-611339837
5075,1990,SOM,258380365,101776258,-156604107
5076,1990,SPM,68094320,24570236,-43524084
5077,1990,STP,46834071,3859302,-42974769
5078,1990,SUR,421134259,532947475,111813216
5079,1990,SWE,52397042420,56134177204,3737134784
5080,1990,SYC,177305680,116216815,-61088865
5081,1990,SYR,2311247186,2686144422,374897236
5082,1990,TCA,48953530,4365227,-44588303
5083,1990,TCD,132390097,96272331,-36117766
5084,1990,TGO,730847621,289835070,-441012551
5085,1990,THA,31460859681,23322118857,-8138740824
5086,1990,TKL,1199671,25387931,24188260
5087,1990,TLS,822842,104120,-718722
5088,1990,TON,48356549,12841283,-35515266
5089,1990,TTO,1133694014,1870539891,736845877
5090,1990,TUN,5237551780,3547342697,-1690209083
5091,1990,TUR,20730010272,13150393619,-7579616653
5092,1990,TUV,5919097,256420,-5662677
5093,1990,TWN,51677980308,70958168254,19280187946
5094,1990,TZA,928605487,427723376,-500882111
5095,1990,UGA,502239196,220155662,-282083534
5096,1990,URY,1388696914,1813246671,424549757
5097,1990,USA,5.08E+11,3.96E+11,-1.13E+11
5098,1990,VCT,132582037,109358737,-23223300
5099,1990,VEN,7203643977,16564174559,9360530582
5100,1990,VGB,93977107,12759653,-81217454
5101,1990,VNM,792892140,1333770429,540878289
5102,1990,VUT,266405739,24614857,-241790882
5103,1990,WLF,7196179,1393028,-5803151
5104,1990,WSM,73228944,11294492,-61934452
5105,1990,YEM,535669024,660811836,125142812
5106,1990,ZAF,12580220764,14471934216,1891713452
5107,1990,ZMB,658108306,1321215494,663107188
5108,1990,ZWE,1455476818,1653854841,198378023
5109,1991,ABW,377599421,182156810,-195442611
5110,1991,AGO,1711838776,3125877754,1414038978
5111,1991,AIA,120678043,9166770,-111511273
5112,1991,ALB,346609952,151079334,-195530618
5113,1991,AND,1176672028,35331038,-1141340990
5114,1991,ANT,2399711892,1360223839,-1039488053
5115,1991,ARE,14153385154,19999523018,5846137864
5116,1991,ARG,8608188465,13560765782,4952577317
5117,1991,ATG,187730837,23631652,-164099185
5118,1991,AUS,36131961017,39100799764,2968838747
5119,1991,AUT,49579335165,38795630011,-10783705154
5120,1991,BDI,159335449,85373605,-73961844
5121,1991,BEL,1.24E+11,1.17E+11,-7011915161
5122,1991,BEN,447868427,116327099,-331541328
5123,1991,BFA,302470624,153180249,-149290375
5124,1991,BGD,3244139557,1891621886,-1352517671
5125,1991,BGR,2051479073,1687598000,-363881073
5126,1991,BHR,1978648416,1672345585,-306302831
5127,1991,BHS,1892885832,872434532,-1020451300
5128,1991,BLZ,215849089,112616776,-103232313
5129,1991,BMU,830654494,648262779,-182391715
5130,1991,BOL,993313730,837495613,-155818117
5131,1991,BRA,22657042477,34812820364,12155777887
5132,1991,BRB,488364925,128438869,-359926056
5133,1991,BRN,1668518925,2571154461,902635536
5134,1991,BTN,72319711,2127903,-70191808
5135,1991,CAF,115189194,129427598,14238404
5136,1991,CAN,1.19E+11,1.25E+11,5977695271
5137,1991,CCK,23977216,9639760,-14337456
5138,1991,CHE,68546198664,63427451920,-5118746744
5139,1991,CHL,7771294574,9676274181,1904979607
5140,1991,CHN,64737343255,1.05E+11,40761599323
5141,1991,CIV,1723939325,2526950078,803010753
5142,1991,CMR,1065611320,1666594301,600982981
5143,1991,COD,775905142,1635954417,860049275
5144,1991,COG,594344125,1133568367,539224242
5145,1991,COK,44026809,10126966,-33899843
5146,1991,COL,5280410377,7629996317,2349585940
5147,1991,COM,125334417,30615356,-94719061
5148,1991,CPV,119743921,4784653,-114959268
5149,1991,CRI,2173298486,2443995830,270697344
5150,1991,CUB,1673018424,1008087860,-664930564
5151,1991,CXR,10192494,4328341,-5864153
5152,1991,CYM,307948982,57214611,-250734371
5153,1991,CYP,3344690582,1209990441,-2134700141
5154,1991,DEU,3.50E+11,3.83E+11,33229458080
5155,1991,DJI,350791552,37534754,-313256798
5156,1991,DMA,137995692,106471297,-31524395
5157,1991,DNK,31592447767,33101713375,1509265608
5158,1991,DOM,2741864983,2220965067,-520899916
5159,1991,DZA,8054121781,12458130005,4404008224
5160,1991,ECU,2574924778,3440108330,865183552
5161,1991,EGY,11023225603,4829969908,-6193255695
5162,1991,ESH,9312426,8282268,-1030158
5163,1991,ESP,90342662683,58345937445,-31996725238
5164,1991,ETH,783435258,234624175,-548811083
5165,1991,FIN,19285386614,21313451875,2028065261
5166,1991,FJI,563008420,432006400,-131002020
5167,1991,FLK,36707569,15582235,-21125334
5168,1991,FRA,2.35E+11,2.07E+11,-27771829911
5169,1991,FRO,243832496,426394711,182562215
5170,1991,GAB,805800110,2601602819,1795802709
5171,1991,GBR,1.89E+11,1.60E+11,-29172542221
5172,1991,GHA,1351933579,981834807,-370098772
5173,1991,GIB,520944454,52560562,-468383892
5174,1991,GIN,541355109,610390431,69035322
5175,1991,GMB,244837771,163220467,-81617304
5176,1991,GNB,91467581,30045647,-61421934
5177,1991,GNQ,54745869,37356190,-17389679
5178,1991,GRC,20321500124,8594690993,-11726809131
5179,1991,GRD,99154661,28636043,-70518618
5180,1991,GRL,265375210,486860583,221485373
5181,1991,GTM,2173807475,1838490792,-335316683
5182,1991,GUY,242808401,282825963,40017562
5183,1991,HKG,1.02E+11,97881851654,-4551946783
5184,1991,HND,1161345266,1069688822,-91656444
5185,1991,HTI,585558404,326377015,-259181389
5186,1991,HUN,8162654376,7339776799,-822877577
5187,1991,IDN,23806466776,31214941344,7408474568
5188,1991,IND,18028901934,18154402599,125500665
5189,1991,IOT,13093807,2147220,-10946587
5190,1991,IRL,19712186493,24171424616,4459238123
5191,1991,IRN,17452794842,16336233935,-1116560907
5192,1991,IRQ,387556119,382131126,-5424993
5193,1991,ISL,1379604829,1627485564,247880735
5194,1991,ISR,15758648056,10714510584,-5044137472
5195,1991,ITA,1.61E+11,1.63E+11,2383762977
5196,1991,JAM,1750421584,1401838078,-348583506
5197,1991,JOR,2670782051,932863100,-1737918951
5198,1991,JPN,2.18E+11,3.17E+11,99372362202
5199,1991,KEN,1732953078,1312543300,-420409778
5200,1991,KHM,38272594,52265287,13992693
5201,1991,KIR,53587270,6528728,-47058542
5202,1991,KNA,73323790,29389121,-43934669
5203,1991,KOR,73077816999,68440593581,-4637223418
5204,1991,KWT,4109459831,818955212,-3290504619
5205,1991,LAO,126291336,80932300,-45359036
5206,1991,LBN,2926525129,500610506,-2425914623
5207,1991,LBR,4496350495,728703195,-3767647300
5208,1991,LBY,5533589852,11008373284,5474783432
5209,1991,LCA,232856136,123640627,-109215509
5210,1991,LKA,2904388277,2227917767,-676470510
5211,1991,MAC,1803189238,1806098484,2909246
5212,1991,MAR,7099660842,5584600354,-1515060488
5213,1991,MDG,370939762,383514992,12575230
5214,1991,MDV,163342885,78327262,-85015623
5215,1991,MEX,47889157889,41401277084,-6487880805
5216,1991,MLI,325488612,226356640,-99131972
5217,1991,MLT,2201038348,1103215250,-1097823098
5218,1991,MMR,836649836,640751168,-195898668
5219,1991,MNG,136904072,61634481,-75269591
5220,1991,MOZ,670427281,397117302,-273309979
5221,1991,MRT,416616449,451772899,35156450
5222,1991,MSR,64694222,3705185,-60989037
5223,1991,MUS,1464428884,1193340189,-271088695
5224,1991,MWI,541235359,503261289,-37974070
5225,1991,MYS,35431437926,37750445613,2319007687
5226,1991,NCL,740927268,453331462,-287595806
5227,1991,NER,216599588,238016845,21417257
5228,1991,NGA,6807203846,13261571473,6454367627
5229,1991,NIC,578315544,356826238,-221489306
5230,1991,NIU,16308681,795821,-15512860
5231,1991,NLD,1.43E+11,1.28E+11,-14401188726
5232,1991,NOR,23729433152,33813385081,10083951929
5233,1991,NPL,501228733,297317456,-203911277
5234,1991,NRU,27393813,34081390,6687577
5235,1991,NZL,7896380616,9454483129,1558102513
5236,1991,OMN,3062700169,5372580142,2309879973
5237,1991,PAK,8329084138,6434983061,-1894101077
5238,1991,PAN,9427065818,1941715938,-7485349880
5239,1991,PCN,1229210,3504834,2275624
5240,1991,PER,3173222411,3495837495,322615084
5241,1991,PHL,13069991141,10137483045,-2932508096
5242,1991,PNG,1272914976,912450092,-360464884
5243,1991,POL,14731240439,11981616628,-2749623811
5244,1991,PRK,1273031992,957283291,-315748701
5245,1991,PRT,25532274231,16258415693,-9273858538
5246,1991,PRY,1939894315,908718421,-1031175894
5247,1991,PYF,602016637,67133514,-534883123
5248,1991,QAT,1602628226,3102004177,1499375951
5249,1991,REU,1911368353,141001793,-1770366560
5250,1991,ROU,4481432953,3401859569,-1079573384
5251,1991,RWA,138704742,104385484,-34319258
5252,1991,SAU,30621472239,52612305412,21990833173
5253,1991,SDN,1114724546,340126540,-774598006
5254,1991,SEN,1175977440,710301288,-465676152
5255,1991,SGP,63408441016,57201882550,-6206558466
5256,1991,SHN,13421164,7472030,-5949134
5257,1991,SLB,99660077,86288625,-13371452
5258,1991,SLE,158730040,277116293,118386253
5259,1991,SLV,1288700899,732241272,-556459627
5260,1991,SOM,93774174,79587077,-14187097
5261,1991,SPM,59203092,30823138,-28379954
5262,1991,STP,31189436,3898585,-27290851
5263,1991,SUR,379808802,394604204,14795402
5264,1991,SWE,45916752361,54618646130,8701893769
5265,1991,SYC,161266490,104339322,-56927168
5266,1991,SYR,2317537137,2208776200,-108760937
5267,1991,TCA,48087567,9652426,-38435141
5268,1991,TCD,140780786,98051486,-42729300
5269,1991,TGO,701756529,277859037,-423897492
5270,1991,THA,34400114494,28548591112,-5851523382
5271,1991,TKL,877675,7235643,6357968
5272,1991,TLS,768066,277230,-490836
5273,1991,TON,55014826,27024250,-27990576
5274,1991,TTO,1359110966,1925949513,566838547
5275,1991,TUN,5103664107,3630846084,-1472818023
5276,1991,TUR,19825138871,13565378014,-6259760857
5277,1991,TUV,5873512,686832,-5186680
5278,1991,TWN,60852291648,82141616660,21289325012
5279,1991,TZA,931683831,408734332,-522949499
5280,1991,UGA,390727540,178081838,-212645702
5281,1991,URY,1721268514,1737444993,16176479
5282,1991,USA,5.00E+11,4.22E+11,-78015441929
5283,1991,VCT,126066000,104111828,-21954172
5284,1991,VEN,10274259402,14357730285,4083470883
5285,1991,VGB,161633040,39893017,-121740023
5286,1991,VNM,1658515801,1643993023,-14522778
5287,1991,VUT,103099834,22887019,-80212815
5288,1991,WLF,31651268,1825921,-29825347
5289,1991,WSM,94859518,14743423,-80116095
5290,1991,YEM,1871785994,1260975974,-610810020
5291,1991,ZAF,13464321200,14855448003,1391126803
5292,1991,ZMB,477650170,1145320085,667669915
5293,1991,ZWE,1533801391,1619941459,86140068
5294,1992,ABW,479154021,386684926,-92469095
5295,1992,AGO,2354763626,3597742120,1242978494
5296,1992,AIA,145418051,2116289,-143301762
5297,1992,ALB,492920923,110208942,-382711981
5298,1992,AND,1026740967,29257999,-997482968
5299,1992,ANT,2868656788,1277093390,-1591563398
5300,1992,ARE,17913615935,19260698325,1347082390
5301,1992,ARG,14807702379,13558466305,-1249236074
5302,1992,ARM,55279342,14138969,-41140373
5303,1992,ATG,178146713,32818909,-145327804
5304,1992,AUS,38571013164,40420878803,1849865639
5305,1992,AUT,53469732326,43013862681,-10455869645
5306,1992,AZE,210721869,66660882,-144060987
5307,1992,BDI,146012305,92802521,-53209784
5308,1992,BEL,1.34E+11,1.23E+11,-10909678306
5309,1992,BEN,557429104,109229478,-448199626
5310,1992,BFA,279545628,115160413,-164385215
5311,1992,BGD,3693886951,2508817311,-1185069640
5312,1992,BGR,3916778397,2283544122,-1633234275
5313,1992,BHR,2325201011,1497867324,-827333687
5314,1992,BHS,2193708835,1055276897,-1138431938
5315,1992,BIH,354172059,290574912,-63597147
5316,1992,BLR,680887371,557860817,-123026554
5317,1992,BLZ,242547810,175299098,-67248712
5318,1992,BMU,1047091848,550785564,-496306284
5319,1992,BOL,1370493728,716055317,-654438411
5320,1992,BRA,21832207054,39441086640,17608879586
5321,1992,BRB,380774984,121270514,-259504470
5322,1992,BRN,2136792267,2532266538,395474271
5323,1992,BTN,51333232,6006023,-45327209
5324,1992,CAF,98886312,102043946,3157634
5325,1992,CAN,1.25E+11,1.33E+11,7987446003
5326,1992,CCK,33492602,5326217,-28166385
5327,1992,CHE,67731499813,67290026491,-441473322
5328,1992,CHL,9953174868,10862433648,909258780
5329,1992,CHN,89444553577,1.31E+11,41233660877
5330,1992,CIV,1771321011,2519678311,748357300
5331,1992,CMR,1099143863,1635843428,536699565
5332,1992,COD,646836507,1290748412,643911905
5333,1992,COG,655906575,1401538362,745631787
5334,1992,COK,50928984,5964883,-44964101
5335,1992,COL,7936569598,7611516340,-325053258
5336,1992,COM,117861136,28567951,-89293185
5337,1992,CPV,137762850,7302225,-130460625
5338,1992,CRI,2746878391,2750447897,3569506
5339,1992,CUB,1292164017,998589599,-293574418
5340,1992,CXR,7418803,7706704,287901
5341,1992,CYM,685558614,96744105,-588814509
5342,1992,CYP,4315740408,1096693176,-3219047232
5343,1992,DEU,3.69E+11,4.22E+11,53032447123
5344,1992,DJI,382972338,54076337,-328896001
5345,1992,DMA,130472190,117001550,-13470640
5346,1992,DNK,33603230548,36972872964,3369642416
5347,1992,DOM,3464770704,2634417487,-830353217
5348,1992,DZA,7766818897,11980243146,4213424249
5349,1992,ECU,2895533379,3633235649,737702270
5350,1992,EGY,11381193008,5370656042,-6010536966
5351,1992,ESH,1557901,4578720,3020819
5352,1992,ESP,98794668571,63651867578,-35142800993
5353,1992,EST,326047333,278398875,-47648458
5354,1992,ETH,1169975949,195142372,-974833577
5355,1992,FIN,20633526956,23388635308,2755108352
5356,1992,FJI,625531803,437700558,-187831245
5357,1992,FLK,31746486,11042424,-20704062
5358,1992,FRA,2.47E+11,2.28E+11,-19116007240
5359,1992,FRO,277996036,459134552,181138516
5360,1992,FSM,59747934,33367482,-26380452
5361,1992,GAB,777951113,2375324680,1597373567
5362,1992,GBR,2.05E+11,1.88E+11,-16383571832
5363,1992,GEO,73450587,107857932,34407345
5364,1992,GHA,1870570776,1153667666,-716903110
5365,1992,GIB,525002666,46871974,-478130692
5366,1992,GIN,620669737,545696249,-74973488
5367,1992,GMB,320877846,184887585,-135990261
5368,1992,GNB,97327689,14909142,-82418547
5369,1992,GNQ,57214681,38219646,-18995035
5370,1992,GRC,22914572354,9314024602,-13600547752
5371,1992,GRD,75553950,30303678,-45250272
5372,1992,GRL,341107764,422684496,81576732
5373,1992,GTM,2643493055,2138163088,-505329967
5374,1992,GUY,308071920,367093723,59021803
5375,1992,HKG,1.25E+11,88419196838,-36771105959
5376,1992,HND,1514550499,1364761888,-149788611
5377,1992,HRV,3266231953,3104355674,-161876279
5378,1992,HTI,344832561,138435660,-206396901
5379,1992,HUN,10504020495,9817485918,-686534577
5380,1992,IDN,25041828924,36134801833,11092972909
5381,1992,IND,21758025341,20796934940,-961090401
5382,1992,IOT,4954489,2008613,-2945876
5383,1992,IRL,22237876294,28325188261,6087311967
5384,1992,IRN,19018742761,16072539816,-2946202945
5385,1992,IRQ,514162447,482493385,-31669062
5386,1992,ISL,1541357441,1568171426,26813985
5387,1992,ISR,17585568533,11481991830,-6103576703
5388,1992,ITA,1.73E+11,1.75E+11,2590571321
5389,1992,JAM,1734519278,1410712846,-323806432
5390,1992,JOR,3522362362,1010219601,-2512142761
5391,1992,JPN,2.14E+11,3.46E+11,1.32E+11
5392,1992,KAZ,499942626,395563897,-104378729
5393,1992,KEN,1689501266,1402304871,-287196395
5394,1992,KGZ,32788954,29450293,-3338661
5395,1992,KHM,725309094,172694882,-552614212
5396,1992,KIR,71596117,1180780,-70415337
5397,1992,KNA,67717654,37036394,-30681260
5398,1992,KOR,72520946715,74763655130,2242708415
5399,1992,KWT,6612617722,4337388394,-2275229328
5400,1992,LAO,211201157,102630913,-108570244
5401,1992,LBN,3620154252,533995417,-3086158835
5402,1992,LBR,5270937597,903966661,-4366970936
5403,1992,LBY,4350938101,9675211226,5324273125
5404,1992,LCA,224584149,139313257,-85270892
5405,1992,LKA,3435865727,2498041186,-937824541
5406,1992,LTU,1762604681,1474182188,-288422493
5407,1992,LVA,469038276,546034293,76996017
5408,1992,MAC,2186296833,1850471292,-335825541
5409,1992,MAR,8097387874,5644877098,-2452510776
5410,1992,MDA,131342536,171896550,40554014
5411,1992,MDG,468921193,422165614,-46755579
5412,1992,MDV,170350042,83050797,-87299245
5413,1992,MEX,59018114762,45438961663,-13579153099
5414,1992,MHL,56336327,10479476,-45856851
5415,1992,MLI,388061393,214469442,-173591951
5416,1992,MLT,2602787487,1300531533,-1302255954
5417,1992,MMR,998259030,830360507,-167898523
5418,1992,MNG,236691843,112242008,-124449835
5419,1992,MNP,64700980,2045076,-62655904
5420,1992,MOZ,933420609,278080635,-655339974
5421,1992,MRT,494946701,406776267,-88170434
5422,1992,MSR,21275288,3642461,-17632827
5423,1992,MUS,1532944331,1334100116,-198844215
5424,1992,MWI,530625298,455290294,-75335004
5425,1992,MYS,36119765049,44729909731,8610144682
5426,1992,NCL,782042795,389855426,-392187369
5427,1992,NER,261818480,176702503,-85115977
5428,1992,NGA,8049369018,12312513198,4263144180
5429,1992,NIC,861723426,322460206,-539263220
5430,1992,NIU,7107042,656784,-6450258
5431,1992,NLD,1.52E+11,1.33E+11,-19001689232
5432,1992,NOR,25906371026,34204571233,8298200207
5433,1992,NPL,548822803,382688862,-166133941
5434,1992,NRU,43202755,51859409,8656654
5435,1992,NZL,8747425145,9954960688,1207535543
5436,1992,OMN,3852534161,5682085016,1829550855
5437,1992,PAK,9270420087,7147334347,-2123085740
5438,1992,PAN,11512662820,2823003793,-8689659027
5439,1992,PCN,1865546,365256,-1500290
5440,1992,PER,3730846619,3567584117,-163262502
5441,1992,PHL,16175973402,11522889302,-4653084100
5442,1992,PLW,42008715,52465097,10456382
5443,1992,PNG,1251237653,1264639356,13401703
5444,1992,POL,17700594299,14226458532,-3474135767
5445,1992,PRK,1222020562,837421024,-384599538
5446,1992,PRT,29112774642,18413568634,-10699206008
5447,1992,PRY,1995806529,782323497,-1213483032
5448,1992,PYF,619698783,57533182,-562165601
5449,1992,QAT,1782422870,3565393049,1782970179
5450,1992,REU,2137293138,170058187,-1967234951
5451,1992,ROU,5846405344,4530363229,-1316042115
5452,1992,RUS,31293747127,38252796552,6959049425
5453,1992,RWA,173372160,83589196,-89782964
5454,1992,SAU,34354554668,53057042165,18702487497
5455,1992,SDN,873535365,313142013,-560393352
5456,1992,SEN,1250049418,654236239,-595813179
5457,1992,SGP,70994999101,61335536775,-9659462326
5458,1992,SHN,26340574,7519183,-18821391
5459,1992,SLB,152264583,114321659,-37942924
5460,1992,SLE,170029578,363109263,193079685
5461,1992,SLV,1709375384,843824781,-865550603
5462,1992,SOM,137829535,88262280,-49567255
5463,1992,SPM,58940583,33074303,-25866280
5464,1992,STP,31909460,5545581,-26363879
5465,1992,SUR,584613776,411242530,-173371246
5466,1992,SVN,4245287882,4280902172,35614290
5467,1992,SWE,48080034216,52842940160,4762905944
5468,1992,SYC,171757297,65426597,-106330700
5469,1992,SYR,3424409391,3084237813,-340171578
5470,1992,TCA,46063976,16447920,-29616056
5471,1992,TCD,115419233,77950256,-37468977
5472,1992,TGO,740736039,188052440,-552683599
5473,1992,THA,37458377623,33124013393,-4334364230
5474,1992,TJK,56672535,41049007,-15623528
5475,1992,TKL,2338761,2905205,566444
5476,1992,TKM,148066043,106198167,-41867876
5477,1992,TLS,847845,431249,-416596
5478,1992,TON,56069012,20191673,-35877339
5479,1992,TTO,1302129284,1896594063,594464779
5480,1992,TUN,6118841625,4041893685,-2076947940
5481,1992,TUR,22688155136,15368176857,-7319978279
5482,1992,TUV,7293666,519945,-6773721
5483,1992,TWN,70299016280,90765364150,20466347870
5484,1992,TZA,1173154662,427189081,-745965581
5485,1992,UGA,350713402,189857009,-160856393
5486,1992,UKR,2069290995,1848385822,-220905173
5487,1992,URY,2229487316,1924382612,-305104704
5488,1992,USA,5.32E+11,4.51E+11,-80996652681
5489,1992,UZB,354525439,258896321,-95629118
5490,1992,VCT,128573946,110668901,-17905045
5491,1992,VEN,12786312459,15028479493,2242167034
5492,1992,VGB,89733438,30481158,-59252280
5493,1992,VNM,3464477008,2412999205,-1051477803
5494,1992,VUT,94310537,29223195,-65087342
5495,1992,WLF,242601739,3337599,-239264140
5496,1992,WSM,195294369,32318298,-162976071
5497,1992,YEM,2155957418,1058175020,-1097782398
5498,1992,ZAF,15843917880,18673738494,2829820614
5499,1992,ZMB,993201296,1222268305,229067009
5500,1992,ZWE,1694431346,1637572919,-56858427
5501,1993,ABW,490540649,584600948,94060299
5502,1993,AGO,1221301333,3138272247,1916970914
5503,1993,AIA,127399535,9102541,-118296994
5504,1993,ALB,597994392,123740735,-474253657
5505,1993,AND,896116011,27495915,-868620096
5506,1993,ANT,2480823770,938309441,-1542514329
5507,1993,ARE,19930338606,18302179886,-1628158720
5508,1993,ARG,16918769964,13654846765,-3263923199
5509,1993,ARM,157950819,33295728,-124655091
5510,1993,ATG,175490722,32625851,-142864871
5511,1993,AUS,39505036855,39447502044,-57534811
5512,1993,AUT,49711343030,40119921392,-9591421638
5513,1993,AZE,242102131,98575896,-143526235
5514,1993,BDI,200740923,93842992,-106897931
5515,1993,BEL,1.14E+11,1.20E+11,6106351320
5516,1993,BEN,679331815,196053686,-483278129
5517,1993,BFA,245902341,109142577,-136759764
5518,1993,BGD,3852545190,2709799614,-1142745576
5519,1993,BGR,2615308165,2192880195,-422427970
5520,1993,BHR,2308169403,1804161930,-504007473
5521,1993,BHS,2928191404,879614834,-2048576570
5522,1993,BIH,338896453,96575853,-242320600
5523,1993,BLR,1012424375,626623213,-385801162
5524,1993,BLZ,271720129,188198925,-83521204
5525,1993,BMU,1145277711,359728769,-785548942
5526,1993,BOL,1376223676,624816134,-751407542
5527,1993,BRA,26893089238,40269668884,13376579646
5528,1993,BRB,448428676,155533459,-292895217
5529,1993,BRN,2347208723,2673427134,326218411
5530,1993,BTN,34581574,14840505,-19741069
5531,1993,CAF,92763259,112551766,19788507
5532,1993,CAN,1.36E+11,1.43E+11,6933005704
5533,1993,CCK,11791190,2002855,-9788335
5534,1993,CHE,66376625945,65701572986,-675052959
5535,1993,CHL,10608806916,10245348251,-363458665
5536,1993,CHN,1.25E+11,1.55E+11,29863601253
5537,1993,CIV,1418746865,2472264752,1053517887
5538,1993,CMR,819137263,1548329367,729192104
5539,1993,COD,629738727,1020121966,390383239
5540,1993,COG,594485393,1303105554,708620161
5541,1993,COK,56539831,8375023,-48164808
5542,1993,COL,9069738103,7762004099,-1307734004
5543,1993,COM,126229108,24473697,-101755411
5544,1993,CPV,140122791,3777862,-136344929
5545,1993,CRI,3141189187,2895416934,-245772253
5546,1993,CUB,1342614847,607267202,-735347645
5547,1993,CXR,17072933,1365169,-15707764
5548,1993,CYM,495010517,97948408,-397062109
5549,1993,CYP,3594069858,1100877050,-2493192808
5550,1993,CZE,14152334012,13752621110,-399712902
5551,1993,DEU,3.36E+11,3.78E+11,42637114725
5552,1993,DJI,357872130,41468418,-316403712
5553,1993,DMA,146268085,107583471,-38684614
5554,1993,DNK,27815251519,33149340513,5334088994
5555,1993,DOM,3925042837,2908642335,-1016400502
5556,1993,DZA,7797787943,10764407383,2966619440
5557,1993,ECU,3074466710,3560089006,485622296
5558,1993,EGY,11970982856,5046637263,-6924345593
5559,1993,ERI,8691515,1370786,-7320729
5560,1993,ESH,2612227,5035579,2423352
5561,1993,ESP,75622143882,60279144185,-15342999697
5562,1993,EST,472052141,375635494,-96416647
5563,1993,ETH,1136243590,254476855,-881766735
5564,1993,FIN,17692819378,23589147969,5896328591
5565,1993,FJI,578102794,406340641,-171762153
5566,1993,FLK,22800948,10962567,-11838381
5567,1993,FRA,2.13E+11,2.03E+11,-9852724864
5568,1993,FRO,172681094,347524876,174843782
5569,1993,FSM,60059875,73851889,13792014
5570,1993,GAB,779525644,2374830661,1595305017
5571,1993,GBR,2.01E+11,1.67E+11,-33999908630
5572,1993,GEO,231705318,88973972,-142731346
5573,1993,GHA,1493454214,979687002,-513767212
5574,1993,GIB,582027939,59170000,-522857939
5575,1993,GIN,527341613,631570657,104229044
5576,1993,GMB,314343324,130195112,-184148212
5577,1993,GNB,107245411,34604284,-72641127
5578,1993,GNQ,48107027,40146398,-7960629
5579,1993,GRC,21541869446,8467874570,-13073994876
5580,1993,GRD,103367205,29106815,-74260390
5581,1993,GRL,258609097,427990150,169381053
5582,1993,GTM,2905574499,2237151464,-668423035
5583,1993,GUY,348321610,376342983,28021373
5584,1993,HKG,1.45E+11,98606437026,-46855428994
5585,1993,HND,1837317386,1467842204,-369475182
5586,1993,HRV,4522794787,3633738558,-889056229
5587,1993,HTI,358320701,181168781,-177151920
5588,1993,HUN,12154298246,8789615792,-3364682454
5589,1993,IDN,26599087476,39235979675,12636892199
5590,1993,IND,23508642900,24507524007,998881107
5591,1993,IOT,1996423,3398891,1402468
5592,1993,IRL,21290168229,27521573337,6231405108
5593,1993,IRN,12812402527,15317740208,2505337681
5594,1993,IRQ,483658030,481248686,-2409344
5595,1993,ISL,1193122946,1532836597,339713651
5596,1993,ISR,18726878200,13175215522,-5551662678
5597,1993,ITA,1.39E+11,1.67E+11,27885381774
5598,1993,JAM,2133728097,1519891527,-613836570
5599,1993,JOR,3614352967,1027802867,-2586550100
5600,1993,JPN,2.19E+11,3.67E+11,1.47E+11
5601,1993,KAZ,1378114013,856086040,-522027973
5602,1993,KEN,1571718768,1569560569,-2158199
5603,1993,KGZ,112957716,83570980,-29386736
5604,1993,KHM,787661537,255970518,-531691019
5605,1993,KIR,54014726,7590294,-46424432
5606,1993,KNA,92405914,39384485,-53021429
5607,1993,KOR,77182957139,80802817183,3619860044
5608,1993,KWT,6839187885,8900924686,2061736801
5609,1993,LAO,300851489,147038066,-153813423
5610,1993,LBN,3761216350,519389215,-3241827135
5611,1993,LBR,4824605384,647842836,-4176762548
5612,1993,LBY,4880162097,7594440409,2714278312
5613,1993,LCA,238972571,132770002,-106202569
5614,1993,LKA,3789120256,2920938680,-868181576
5615,1993,LTU,806947716,991854651,184906935
5616,1993,LVA,637277953,940047508,302769555
5617,1993,MAC,2327536895,1753951270,-573585625
5618,1993,MAR,7546071232,5292389677,-2253681555
5619,1993,MDA,192806673,167462885,-25343788
5620,1993,MDG,529019467,436199688,-92819779
5621,1993,MDV,178338662,69471676,-108866986
5622,1993,MEX,60290668871,51743039077,-8547629794
5623,1993,MHL,178921493,12724724,-166196769
5624,1993,MKD,1234287016,952313365,-281973651
5625,1993,MLI,373742602,192980741,-180761861
5626,1993,MLT,2883178684,1252676313,-1630502371
5627,1993,MMR,1309377770,937479250,-371898520
5628,1993,MNG,162145978,146362097,-15783881
5629,1993,MNP,58080529,2941610,-55138919
5630,1993,MOZ,844823568,182236791,-662586777
5631,1993,MRT,470325886,388467552,-81858334
5632,1993,MSR,13420217,1906829,-11513388
5633,1993,MUS,1694275424,1333104528,-361170896
5634,1993,MWI,405305081,343103183,-62201898
5635,1993,MYS,42754445442,54574300542,11819855100
5636,1993,NCL,723761843,379148898,-344612945
5637,1993,NER,258855251,162849120,-96006131
5638,1993,NGA,6484990804,11347287850,4862297046
5639,1993,NIC,656871182,283453656,-373417526
5640,1993,NIU,3896210,536598,-3359612
5641,1993,NLD,1.36E+11,1.20E+11,-15956505042
5642,1993,NOR,23997581858,31694011802,7696429944
5643,1993,NPL,532948328,412317880,-120630448
5644,1993,NRU,126599880,43921875,-82678005
5645,1993,NZL,9237568870,10424007669,1186438799
5646,1993,OMN,4097152510,5565316185,1468163675
5647,1993,PAK,9781597810,6726053780,-3055544030
5648,1993,PAN,11679942750,2627915799,-9052026951
5649,1993,PCN,2539054,11810485,9271431
5650,1993,PER,3991888519,3414528762,-577359757
5651,1993,PHL,19995238590,12761017978,-7234220612
5652,1993,PLW,33758082,35442457,1684375
5653,1993,PNG,1241951296,1694894876,452943580
5654,1993,POL,19874616132,14653371015,-5221245117
5655,1993,PRK,1318096287,960975941,-357120346
5656,1993,PRT,24188152911,15429892254,-8758260657
5657,1993,PRY,2862315539,893951613,-1968363926
5658,1993,PYF,620759544,76928756,-543830788
5659,1993,QAT,1823622295,3536707724,1713085429
5660,1993,REU,1826266643,157286947,-1668979696
5661,1993,ROU,6300417912,4758589747,-1541828165
5662,1993,RUS,30568498588,38451567021,7883068433
5663,1993,RWA,194771651,85435342,-109336309
5664,1993,SAU,31928911936,45525636277,13596724341
5665,1993,SDN,775901651,388229659,-387671992
5666,1993,SEN,1137921630,563358319,-574563311
5667,1993,SGP,84690677376,72356086985,-12334590391
5668,1993,SHN,43327865,5279870,-38047995
5669,1993,SLB,104742468,162800563,58058095
5670,1993,SLE,188418049,212260977,23842928
5671,1993,SLV,1986258825,994759226,-991499599
5672,1993,SOM,202456549,78177355,-124279194
5673,1993,SPM,41523625,2110132,-39413493
5674,1993,STP,37170986,7910111,-29260875
5675,1993,SUR,433637329,375029237,-58608092
5676,1993,SVK,5006149043,4328630738,-677518305
5677,1993,SVN,6140016822,5844734520,-295282302
5678,1993,SWE,42668981490,48016410369,5347428879
5679,1993,SYC,263969541,48690563,-215278978
5680,1993,SYR,3427701952,2598409288,-829292664
5681,1993,TCA,28524957,12560692,-15964265
5682,1993,TCD,89774585,63805282,-25969303
5683,1993,TGO,390755288,130838732,-259916556
5684,1993,THA,43379590555,37753170208,-5626420347
5685,1993,TJK,111822168,126626682,14804514
5686,1993,TKL,4422404,6287578,1865174
5687,1993,TKM,353263637,295790576,-57473061
5688,1993,TLS,1399322,562331,-836991
5689,1993,TON,43977757,20168396,-23809361
5690,1993,TTO,1311925347,1758215736,446290389
5691,1993,TUN,5855520081,3719206358,-2136313723
5692,1993,TUR,29133690544,15739443161,-13394247383
5693,1993,TUV,5741544,818139,-4923405
5694,1993,TWN,74261664534,1.01E+11,27163123401
5695,1993,TZA,1101115020,470865680,-630249340
5696,1993,UGA,402183284,168541526,-233641758
5697,1993,UKR,3215752699,3402746426,186993727
5698,1993,URY,2929242135,2120808083,-808434052
5699,1993,USA,5.82E+11,4.64E+11,-1.18E+11
5700,1993,UZB,815014052,579088138,-235925914
5701,1993,VCT,178624730,117762501,-60862229
5702,1993,VEN,11325626192,14819300215,3493674023
5703,1993,VGB,185441705,48986594,-136455111
5704,1993,VNM,4997902527,3131312307,-1866590220
5705,1993,VUT,184042457,45378120,-138664337
5706,1993,WLF,30557832,1809109,-28748723
5707,1993,WSM,104847609,53024896,-51822713
5708,1993,YEM,2152528873,1197120501,-955408372
5709,1993,ZAF,15719562529,20802932555,5083370026
5710,1993,ZMB,966217885,1029460977,63243092
5711,1993,ZWE,1618758512,1529614498,-89144014
5712,1994,ABW,475509913,556538420,81028507
5713,1994,AGO,1242597173,3028701677,1786104504
5714,1994,AIA,144831534,2318771,-142512763
5715,1994,ALB,661376319,166137924,-495238395
5716,1994,AND,841295958,44700297,-796595661
5717,1994,ANT,2380489028,1138464595,-1242024433
5718,1994,ARE,20873893777,17684212168,-3189681609
5719,1994,ARG,21059372773,16600022397,-4459350376
5720,1994,ARM,154815887,46634772,-108181115
5721,1994,ATG,205167220,35755648,-169411572
5722,1994,AUS,48857560581,44549832797,-4307727784
5723,1994,AUT,56735010332,45202042650,-11532967682
5724,1994,AZE,307929258,70905973,-237023285
5725,1994,BDI,212173075,96718225,-115454850
5726,1994,BEL,1.31E+11,1.36E+11,4977178604
5727,1994,BEN,506018759,186074597,-319944162
5728,1994,BFA,190672562,87177756,-103494806
5729,1994,BGD,4268257473,2889956052,-1378301421
5730,1994,BGR,3297313023,2968502516,-328810507
5731,1994,BHR,3678306708,1789476049,-1888830659
5732,1994,BHS,2247787368,622732145,-1625055223
5733,1994,BIH,599090097,32401887,-566688210
5734,1994,BLR,1254772070,1063660316,-191111754
5735,1994,BLZ,236755337,186324358,-50430979
5736,1994,BMU,887921237,203721993,-684199244
5737,1994,BOL,1634069675,918176728,-715892947
5738,1994,BRA,34680175685,46710739302,12030563617
5739,1994,BRB,473736050,141751027,-331985023
5740,1994,BRN,2898643549,2424348569,-474294980
5741,1994,BTN,33367327,24590248,-8777079
5742,1994,CAF,95234325,100630465,5396140
5743,1994,CAN,1.56E+11,1.66E+11,10659105393
5744,1994,CCK,18456800,1418976,-17037824
5745,1994,CHE,71744420781,72340068838,595648057
5746,1994,CHL,11570605221,12433839967,863234746
5747,1994,CHN,1.47E+11,1.87E+11,40348604027
5748,1994,CIV,1265443035,2797810337,1532367302
5749,1994,CMR,701013513,1739856479,1038842966
5750,1994,COD,773527236,1306725126,533197890
5751,1994,COG,474745889,1285868124,811122235
5752,1994,COK,68849814,10080662,-58769152
5753,1994,COL,11555829593,8957904418,-2597925175
5754,1994,COM,130005144,20401160,-109603984
5755,1994,CPV,196649965,8035741,-188614224
5756,1994,CRI,3519044337,3523602496,4558159
5757,1994,CUB,1202688196,946001725,-256686471
5758,1994,CXR,20941855,7666532,-13275323
5759,1994,CYM,685528614,119639977,-565888637
5760,1994,CYP,4146252679,1056842845,-3089409834
5761,1994,CZE,17488302054,15251008125,-2237293929
5762,1994,DEU,3.81E+11,4.25E+11,44051177739
5763,1994,DJI,283978540,7475322,-276503218
5764,1994,DMA,171621032,109263596,-62357436
5765,1994,DNK,34902075031,36891703417,1989628386
5766,1994,DOM,4441836776,3442361672,-999475104
5767,1994,DZA,9121825371,9629609279,507783908
5768,1994,ECU,3956810018,4576113917,619303899
5769,1994,EGY,13227883654,5776788427,-7451095227
5770,1994,ERI,43983751,4325293,-39658458
5771,1994,ESH,6288928,1744896,-4544032
5772,1994,ESP,93735891206,72774788698,-20961102508
5773,1994,EST,1423223183,929064696,-494158487
5774,1994,ETH,949412478,303232206,-646180272
5775,1994,FIN,22916924996,29028385024,6111460028
5776,1994,FJI,731808073,528945164,-202862909
5777,1994,FLK,18802169,17903576,-898593
5778,1994,FRA,2.45E+11,2.31E+11,-14084675511
5779,1994,FRO,197015833,332454120,135438287
5780,1994,FSM,57125967,143582872,86456905
5781,1994,GAB,651446898,2462489036,1811042138
5782,1994,GBR,2.20E+11,2.01E+11,-18900818096
5783,1994,GEO,272206804,50094927,-222111877
5784,1994,GHA,1482401280,1321592155,-160809125
5785,1994,GIB,678331056,65293286,-613037770
5786,1994,GIN,529399001,601250935,71851934
5787,1994,GMB,237493282,126917414,-110575868
5788,1994,GNB,130083184,74085257,-55997927
5789,1994,GNQ,52379556,49493341,-2886215
5790,1994,GRC,21275530743,9266208010,-12009322733
5791,1994,GRD,91859303,23625685,-68233618
5792,1994,GRL,263547169,419783540,156236371
5793,1994,GTM,3077483187,2611658864,-465824323
5794,1994,GUY,308065023,404325478,96260455
5795,1994,HKG,1.70E+11,1.50E+11,-20406311114
5796,1994,HND,1989955973,1773116445,-216839528
5797,1994,HRV,6033323107,4093636058,-1939687049
5798,1994,HTI,331291722,81933876,-249357846
5799,1994,HUN,15308794252,10885187269,-4423606983
5800,1994,IDN,30328789119,43943920250,13615131131
5801,1994,IND,27844742279,27819392745,-25349534
5802,1994,IOT,4689220,10873711,6184491
5803,1994,IRL,27250309087,32987014133,5736705046
5804,1994,IRN,8758287344,14064023803,5305736459
5805,1994,IRQ,387821231,421663931,33842700
5806,1994,ISL,1253101827,1652969232,399867405
5807,1994,ISR,21760554395,15187330353,-6573224042
5808,1994,ITA,1.60E+11,1.89E+11,28989867878
5809,1994,JAM,2062781772,1638874120,-423907652
5810,1994,JOR,3520334713,1134561383,-2385773330
5811,1994,JPN,2.57E+11,4.10E+11,1.52E+11
5812,1994,KAZ,1544939557,956642050,-588297507
5813,1994,KEN,2403809617,1789754882,-614054735
5814,1994,KGZ,123930689,123604985,-325704
5815,1994,KHM,960476449,239108988,-721367461
5816,1994,KIR,55604164,10382121,-45222043
5817,1994,KNA,92751129,33834658,-58916471
5818,1994,KOR,94517581670,94274323321,-243258349
5819,1994,KWT,6421267233,8299215661,1877948428
5820,1994,LAO,465187992,197293776,-267894216
5821,1994,LBN,4525052684,497728019,-4027324665
5822,1994,LBR,5531598366,589857391,-4941740975
5823,1994,LBY,3742847988,7979554280,4236706292
5824,1994,LCA,255504658,105553653,-149951005
5825,1994,LKA,4615036142,3323375720,-1291660422
5826,1994,LTU,2379045583,2424458984,45413401
5827,1994,LVA,1598468554,1408109739,-190358815
5828,1994,MAC,2721268544,1875616420,-845652124
5829,1994,MAR,8206522759,5830618484,-2375904275
5830,1994,MDA,689518026,637053814,-52464212
5831,1994,MDG,590329802,541303077,-49026725
5832,1994,MDV,234615778,62328916,-172286862
5833,1994,MEX,73784174300,61518506595,-12265667705
5834,1994,MHL,49929300,31487310,-18441990
5835,1994,MKD,1726182112,1389733048,-336449064
5836,1994,MLI,326849084,175469660,-151379424
5837,1994,MLT,2863384077,1475447401,-1387936676
5838,1994,MMR,1607387298,972491220,-634896078
5839,1994,MNG,144687151,194667312,49980161
5840,1994,MNP,58986905,1615065,-57371840
5841,1994,MOZ,868922155,209296931,-659625224
5842,1994,MRT,457666360,434980403,-22685957
5843,1994,MSR,20287524,2900176,-17387348
5844,1994,MUS,1889184401,1340436124,-548748277
5845,1994,MWI,491029072,426226251,-64802821
5846,1994,MYS,63359924940,66502025123,3142100183
5847,1994,NCL,703345457,420305781,-283039676
5848,1994,NER,213065465,102750703,-110314762
5849,1994,NGA,4391143518,10865007359,6473863841
5850,1994,NIC,791052563,377542957,-413509606
5851,1994,NIU,4954650,229462,-4725188
5852,1994,NLD,1.56E+11,1.34E+11,-22050853388
5853,1994,NOR,27403008805,36770933899,9367925094
5854,1994,NPL,625883258,404860969,-221022289
5855,1994,NRU,25046345,32641409,7595064
5856,1994,NZL,11533046611,11886346035,353299424
5857,1994,OMN,4205597668,5754354321,1548756653
5858,1994,PAK,7361862879,6191907953,-1169954926
5859,1994,PAN,14286700172,2768444511,-11518255661
5860,1994,PCN,4565195,2165651,-2399544
5861,1994,PER,5423512865,4553405546,-870107319
5862,1994,PHL,23650519264,15282623896,-8367895368
5863,1994,PLW,35287436,30275920,-5011516
5864,1994,PNG,1275084508,2474084740,1199000232
5865,1994,POL,21995568891,17556989511,-4438579380
5866,1994,PRK,1057379119,1091861497,34482378
5867,1994,PRT,27283953638,17721825023,-9562128615
5868,1994,PRY,3815574478,968630617,-2846943861
5869,1994,PYF,603375448,120852818,-482522630
5870,1994,QAT,1859384274,3272584724,1413200450
5871,1994,REU,2047537414,146572755,-1900964659
5872,1994,ROU,6879063082,6052105255,-826957827
5873,1994,RUS,32332589242,47219528882,14886939640
5874,1994,RWA,149726159,39161961,-110564198
5875,1994,SAU,27963355612,44928322069,16964966457
5876,1994,SDN,749582226,434648468,-314933758
5877,1994,SEN,975212046,584899513,-390312533
5878,1994,SGP,1.00E+11,94440483418,-5679300140
5879,1994,SHN,29462558,3739945,-25722613
5880,1994,SLB,104955258,160182294,55227036
5881,1994,SLE,196427486,232009753,35582267
5882,1994,SLV,2297836877,1372861907,-924974970
5883,1994,SOM,181846326,80073831,-101772495
5884,1994,SPM,74379014,17884728,-56494286
5885,1994,STP,50044282,8605834,-41438448
5886,1994,SUR,755070833,355383168,-399687665
5887,1994,SVK,6950766225,6544872660,-405893565
5888,1994,SVN,7076534151,6809693399,-266840752
5889,1994,SWE,51386188407,58071853534,6685665127
5890,1994,SYC,190870680,68571408,-122299272
5891,1994,SYR,4134723914,2467781856,-1666942058
5892,1994,TCA,40577845,10218534,-30359311
5893,1994,TCD,83596831,61184732,-22412099
5894,1994,TGO,471403080,244248481,-227154599
5895,1994,THA,50653387746,46496774053,-4156613693
5896,1994,TJK,82363458,250014428,167650970
5897,1994,TKL,6014742,5420263,-594479
5898,1994,TKM,506731269,358688844,-148042425
5899,1994,TLS,2863428,1963206,-900222
5900,1994,TON,69710386,21077696,-48632690
5901,1994,TTO,1252490280,2181678805,929188525
5902,1994,TUN,6218044825,4426376305,-1791668520
5903,1994,TUR,22831137979,18324529747,-4506608232
5904,1994,TUV,7664619,1285031,-6379588
5905,1994,TWN,82404849901,1.12E+11,30076293063
5906,1994,TZA,1174215831,465728602,-708487229
5907,1994,UGA,628610500,399465443,-229145057
5908,1994,UKR,3800837086,5213358038,1412520952
5909,1994,URY,3199004850,2649001714,-550003136
5910,1994,USA,6.92E+11,5.27E+11,-1.65E+11
5911,1994,UZB,1131185596,1077404583,-53781013
5912,1994,VCT,202231038,96510678,-105720360
5913,1994,VEN,9205218228,16228492037,7023273809
5914,1994,VGB,218507705,79534278,-138973427
5915,1994,VNM,6559421623,4276835641,-2282585982
5916,1994,VUT,132547912,29847393,-102700519
5917,1994,WLF,15665067,1219909,-14445158
5918,1994,WSM,112899255,52087838,-60811417
5919,1994,YEM,1676242531,1549507626,-126734905
5920,1994,ZAF,18988138102,21297812057,2309673955
5921,1994,ZMB,742436877,1053601405,311164528
5922,1994,ZWE,1792008894,1870014515,78005621
5923,1995,ABW,575862922,642538313,66675391
5924,1995,AGO,1670495184,3422873459,1752378275
5925,1995,AIA,328977008,4441946,-324535062
5926,1995,ALB,854210706,228532192,-625678514
5927,1995,AND,1003938506,44642690,-959295816
5928,1995,ANT,2587063179,1163843078,-1423220101
5929,1995,ARE,22275003545,18529149335,-3745854210
5930,1995,ARG,19700951470,21935747955,2234796485
5931,1995,ARM,175639367,61870892,-113768475
5932,1995,ATG,262709871,49464107,-213245764
5933,1995,AUS,53618259204,49986784336,-3631474868
5934,1995,AUT,63801818777,53550882695,-10250936082
5935,1995,AZE,444011122,142881136,-301129986
5936,1995,BDI,195731214,197482618,1751404
5937,1995,BEL,1.55E+11,1.54E+11,-1241738077
5938,1995,BEN,790856872,191750657,-599106215
5939,1995,BFA,427972549,102452594,-325519955
5940,1995,BGD,5865504911,3889514549,-1975990362
5941,1995,BGR,4183758406,3970132635,-213625771
5942,1995,BHR,1552073651,1622678119,70604468
5943,1995,BHS,1769835064,621255178,-1148579886
5944,1995,BIH,817030731,55469660,-761561071
5945,1995,BLR,2189109811,1596345408,-592764403
5946,1995,BLZ,280747041,209748945,-70998096
5947,1995,BMU,782487696,230414203,-552073493
5948,1995,BOL,1930702188,1016547897,-914154291
5949,1995,BRA,53027925015,49983208468,-3044716547
5950,1995,BRB,487405851,149569111,-337836740
5951,1995,BRN,3035372548,2390089670,-645282878
5952,1995,BTN,35251751,45149821,9898070
5953,1995,CAF,154600075,155445369,845294
5954,1995,CAN,1.70E+11,1.93E+11,22892393143
5955,1995,CCK,8112633,7658025,-454608
5956,1995,CHE,84904294436,86214499925,1310205489
5957,1995,CHL,15083979945,16495382518,1411402573
5958,1995,CHN,1.69E+11,2.26E+11,57195897870
5959,1995,CIV,2842966357,4381353434,1538387077
5960,1995,CMR,1156728528,2067209220,910480692
5961,1995,COD,1119640391,1429185087,309544696
5962,1995,COG,773702859,1483606593,709903734
5963,1995,COK,48912229,6474654,-42437575
5964,1995,COL,13146547663,10986736059,-2159811604
5965,1995,COM,166646931,12761071,-153885860
5966,1995,CPV,222007733,11251330,-210756403
5967,1995,CRI,3469387911,3945674246,476286335
5968,1995,CUB,2118760291,1117668941,-1001091350
5969,1995,CXR,22565555,2226195,-20339360
5970,1995,CYM,693675395,130897688,-562777707
5971,1995,CYP,4443260882,1448074223,-2995186659
5972,1995,CZE,24632412726,20662279579,-3970133147
5973,1995,DEU,4.59E+11,5.14E+11,54729961323
5974,1995,DJI,340358598,46008898,-294349700
5975,1995,DMA,183920489,97674961,-86245528
5976,1995,DNK,42014405692,43096106275,1081700583
5977,1995,DOM,4598861134,3782145268,-816715866
5978,1995,DZA,10413616119,11352918738,939302619
5979,1995,ECU,4528090809,5131035528,602944719
5980,1995,EGY,15214498781,5792439527,-9422059254
5981,1995,ERI,128140506,10921242,-117219264
5982,1995,ESH,1571588,527762,-1043826
5983,1995,ESP,1.13E+11,88938874426,-23976159173
5984,1995,EST,2742450786,2178277671,-564173115
5985,1995,ETH,1305432459,542193193,-763239266
5986,1995,FIN,29116825175,38638634004,9521808829
5987,1995,FJI,650287447,542626584,-107660863
5988,1995,FLK,42809632,25359041,-17450591
5989,1995,FRA,2.83E+11,2.78E+11,-4980033942
5990,1995,FRO,210390899,347475502,137084603
5991,1995,FSM,57575772,119054042,61478270
5992,1995,GAB,778929431,2566697396,1787767965
5993,1995,GBR,2.54E+11,2.22E+11,-32117396408
5994,1995,GEO,367595916,105057958,-262537958
5995,1995,GHA,1835609795,1385364234,-450245561
5996,1995,GIB,621793760,86808526,-534985234
5997,1995,GIN,865623063,737448489,-128174574
5998,1995,GMB,251686639,167714456,-83972183
5999,1995,GNB,112099990,101997785,-10102205
6000,1995,GNQ,81553390,103279503,21726113
6001,1995,GRC,25758293630,10577630777,-15180662853
6002,1995,GRD,103798127,23562223,-80235904
6003,1995,GRL,290761111,462717204,171956093
6004,1995,GTM,3711374356,3230477579,-480896777
6005,1995,GUY,383408482,436488792,53080310
6006,1995,HKG,1.93E+11,1.24E+11,-68464354065
6007,1995,HND,2347749422,2286150337,-61599085
6008,1995,HRV,7595456576,4415680997,-3179775579
6009,1995,HTI,847879595,179557705,-668321890
6010,1995,HUN,17256306682,13770947677,-3485359005
6011,1995,IDN,41051726271,49322202629,8270476358
6012,1995,IND,35687475691,33549397287,-2138078404
6013,1995,IOT,6120562,16256532,10135970
6014,1995,IRL,32527038543,42736720294,10209681751
6015,1995,IRN,8824326942,15384525285,6560198343
6016,1995,IRQ,516809842,463734997,-53074845
6017,1995,ISL,1579158014,1840531868,261373854
6018,1995,ISR,25542010118,17892571759,-7649438359
6019,1995,ITA,1.92E+11,2.28E+11,36142866615
6020,1995,JAM,2467327882,1734607550,-732720332
6021,1995,JOR,4024419549,1499042567,-2525376982
6022,1995,JPN,3.07E+11,4.55E+11,1.48E+11
6023,1995,KAZ,3947039082,4425647055,478607973
6024,1995,KEN,2574188947,1513415445,-1060773502
6025,1995,KGZ,608383620,479772782,-128610838
6026,1995,KHM,1298184852,315187007,-982997845
6027,1995,KIR,28993931,4851957,-24141974
6028,1995,KNA,100270449,40374782,-59895667
6029,1995,KOR,1.26E+11,1.22E+11,-3446011899
6030,1995,KWT,5980038741,9685766329,3705727588
6031,1995,LAO,555840786,235628400,-320212386
6032,1995,LBN,5315014324,514794748,-4800219576
6033,1995,LBR,5135965108,897911864,-4238053244
6034,1995,LBY,4394123222,8774362840,4380239618
6035,1995,LCA,308568122,123828414,-184739708
6036,1995,LKA,4305079021,3302904430,-1002174591
6037,1995,LTU,3606557696,3129347812,-477209884
6038,1995,LVA,2415657887,2570729515,155071628
6039,1995,MAC,2917629554,1985756890,-931872664
6040,1995,MAR,9648580117,7041518665,-2607061452
6041,1995,MDA,948463424,833202117,-115261307
6042,1995,MDG,677806907,652077242,-25729665
6043,1995,MDV,242613169,49265673,-193347496
6044,1995,MEX,64987031722,80203689610,15216657888
6045,1995,MHL,582949082,35389493,-547559589
6046,1995,MKD,1999569984,1512972760,-486597224
6047,1995,MLI,622006386,235738406,-386267980
6048,1995,MLT,3576917912,1720063399,-1856854513
6049,1995,MMR,2428405613,1255719919,-1172685694
6050,1995,MNG,269178873,308192188,39013315
6051,1995,MNP,80894003,4184903,-76709100
6052,1995,MOZ,1088203838,237320223,-850883615
6053,1995,MRT,529452603,589358704,59906101
6054,1995,MSR,29864850,13069287,-16795563
6055,1995,MUS,1992844781,1586051717,-406793064
6056,1995,MWI,416408099,424739372,8331273
6057,1995,MYS,82534771969,80701287268,-1833484701
6058,1995,NCL,822444814,542838582,-279606232
6059,1995,NER,335450706,175974856,-159475850
6060,1995,NGA,4795247628,12376304973,7581057345
6061,1995,NIC,1008763789,524787815,-483975974
6062,1995,NIU,38642039,787134,-37854905
6063,1995,NLD,1.85E+11,1.65E+11,-20679893432
6064,1995,NOR,32160943499,44973618732,12812675233
6065,1995,NPL,719323052,350674260,-368648792
6066,1995,NRU,27349795,46925973,19576178
6067,1995,NZL,13406388438,13650861571,244473133
6068,1995,OMN,4300703178,6061201860,1760498682
6069,1995,PAK,8503610208,6542195496,-1961414712
6070,1995,PAN,15917018900,2956856250,-12960162650
6071,1995,PCN,6876707,4477003,-2399704
6072,1995,PER,7410898199,5646754831,-1764143368
6073,1995,PHL,25112619987,17333104354,-7779515633
6074,1995,PLW,23316090,25064758,1748668
6075,1995,PNG,1159993132,2487609332,1327616200
6076,1995,POL,30709595454,23255551270,-7454044184
6077,1995,PRK,1248333062,866750871,-381582191
6078,1995,PRT,32968245581,22470287037,-10497958544
6079,1995,PRY,4709656121,1290783305,-3418872816
6080,1995,PYF,666981376,113150302,-553831074
6081,1995,QAT,2350835314,3251123634,900288320
6082,1995,REU,2419655686,177987219,-2241668467
6083,1995,ROU,9869721759,7972664530,-1897057229
6084,1995,RUS,42349028366,59115618535,16766590169
6085,1995,RWA,138666748,45124264,-93542484
6086,1995,SAU,27886302422,46156118858,18269816436
6087,1995,SDN,1058056787,594528265,-463528522
6088,1995,SEN,1276808904,500534374,-776274530
6089,1995,SGP,1.20E+11,1.18E+11,-2010457506
6090,1995,SHN,21373145,5013111,-16360034
6091,1995,SLB,116485545,186982269,70496724
6092,1995,SLE,195728130,177289099,-18439031
6093,1995,SLV,2610054584,1712125077,-897929507
6094,1995,SOM,72257196,119984814,47727618
6095,1995,SPM,54652138,6274047,-48378091
6096,1995,STP,41330938,6522537,-34808401
6097,1995,SUR,842881644,495395812,-347485832
6098,1995,SVK,9205608984,9096846790,-108762194
6099,1995,SVN,9574966093,8259283402,-1315682691
6100,1995,SWE,59961221018,75812068835,15850847817
6101,1995,SYC,192586731,41893239,-150693492
6102,1995,SYR,3838171912,2894050127,-944121785
6103,1995,TCA,52921836,12932047,-39989789
6104,1995,TCD,162704643,118974566,-43730077
6105,1995,TGO,782573803,371244192,-411329611
6106,1995,THA,68228133312,57101755152,-11126378160
6107,1995,TJK,183875815,256603202,72727387
6108,1995,TKL,4528949,7918136,3389187
6109,1995,TKM,336213188,668553602,332340414
6110,1995,TLS,3139018,781064,-2357954
6111,1995,TON,55784235,19444848,-36339387
6112,1995,TTO,1591259243,2361009958,769750715
6113,1995,TUN,7626179504,5363818232,-2262361272
6114,1995,TUR,34320629583,21679708906,-12640920677
6115,1995,TUV,4826996,1044004,-3782992
6116,1995,TWN,92281951298,1.15E+11,22965980904
6117,1995,TZA,1353156103,602851153,-750304950
6118,1995,UGA,877735365,609661240,-268074125
6119,1995,UKR,6000183874,6345778589,345594715
6120,1995,URY,3496855854,2529828409,-967027445
6121,1995,USA,7.44E+11,6.08E+11,-1.36E+11
6122,1995,UZB,1592029079,1631086274,39057195
6123,1995,VCT,222409640,102267923,-120141717
6124,1995,VEN,11555658828,20108708839,8553050011
6125,1995,VGB,335389661,103284424,-232105237
6126,1995,VNM,8132468069,5170461745,-2962006324
6127,1995,VUT,123643491,27699153,-95944338
6128,1995,WLF,19457948,902609,-18555339
6129,1995,WSM,115245589,57113705,-58131884
6130,1995,YEM,1645810716,1724011354,78200638
6131,1995,ZAF,26011326858,25086548232,-924778626
6132,1995,ZMB,1019824707,1156026262,136201555
6133,1995,ZWE,2354929696,1902571537,-452358159
6134,1996,ABW,798382988,775350399,-23032589
6135,1996,AGO,1863587977,4436984174,2573396197
6136,1996,AIA,29000184,5891047,-23109137
6137,1996,ALB,1192364040,296545262,-895818778
6138,1996,AND,936385200,43775107,-892610093
6139,1996,ANT,3352861786,1559274684,-1793587102
6140,1996,ARE,23029662355,22109930931,-919731424
6141,1996,ARG,23574963336,25039487799,1464524463
6142,1996,ARM,349703082,80477569,-269225513
6143,1996,ATG,281890169,51042819,-230847350
6144,1996,AUS,57061723627,56939200407,-122523220
6145,1996,AUT,67235857569,54771551493,-12464306076
6146,1996,AZE,1121918026,241147352,-880770674
6147,1996,BDI,107370817,87990976,-19379841
6148,1996,BEL,1.62E+11,1.57E+11,-4845276557
6149,1996,BEN,892729474,258845125,-633884349
6150,1996,BFA,480475927,124673508,-355802419
6151,1996,BGD,6426149326,4001355334,-2424793992
6152,1996,BGR,5270208298,4678614046,-591594252
6153,1996,BHR,1751002003,1767457355,16455352
6154,1996,BHS,3073854831,652949477,-2420905354
6155,1996,BIH,1740879379,189391301,-1551488078
6156,1996,BLR,3033493955,1801800359,-1231693596
6157,1996,BLZ,323302012,245760769,-77541243
6158,1996,BMU,762737304,338069898,-424667406
6159,1996,BOL,2108725391,1090177978,-1018547413
6160,1996,BRA,54726290821,50949312288,-3776978533
6161,1996,BRB,567514526,227873874,-339640652
6162,1996,BRN,4127538254,2697472496,-1430065758
6163,1996,BTN,34728158,40800342,6072184
6164,1996,CAF,109688261,156862664,47174403
6165,1996,CAN,1.77E+11,2.05E+11,28349263368
6166,1996,CCK,10939545,4773294,-6166251
6167,1996,CHE,85881153982,86979550393,1098396411
6168,1996,CHL,16728319982,16928818753,200498771
6169,1996,CHN,1.79E+11,2.45E+11,65787896052
6170,1996,CIV,2868690701,4998609867,2129919166
6171,1996,CMR,1385074176,2178944657,793870481
6172,1996,COD,1089977142,1529485415,439508273
6173,1996,COG,1352520346,1524346095,171825749
6174,1996,COK,47509260,7176837,-40332423
6175,1996,COL,12900507334,11081078232,-1819429102
6176,1996,COM,177343959,20638383,-156705576
6177,1996,CPV,294552379,16392789,-278159590
6178,1996,CRI,3653977635,4125218125,471240490
6179,1996,CUB,2282977720,1303144675,-979833045
6180,1996,CXR,20371232,19024128,-1347104
6181,1996,CYM,486378571,154610018,-331768553
6182,1996,CYP,4424516659,1856969681,-2567546978
6183,1996,CZE,27289952999,21369280874,-5920672125
6184,1996,DEU,4.54E+11,5.19E+11,65618485643
6185,1996,DJI,249004028,16748532,-232255496
6186,1996,DMA,180706735,92303050,-88403685
6187,1996,DNK,42351954524,43595614506,1243659982
6188,1996,DOM,5079946884,4010072043,-1069874841
6189,1996,DZA,8384314743,13627604055,5243289312
6190,1996,ECU,3925139350,5569477069,1644337719
6191,1996,EGY,16085721559,6440101099,-9645620460
6192,1996,ERI,162190664,21092526,-141098138
6193,1996,ESH,1778431,912291,-866140
6194,1996,ESP,1.22E+11,99369398383,-22521867125
6195,1996,EST,3173233686,2571377480,-601856206
6196,1996,ETH,1097614292,439532047,-658082245
6197,1996,FIN,31122775990,39358547470,8235771480
6198,1996,FJI,749589849,598468122,-151121727
6199,1996,FLK,54805660,49737594,-5068066
6200,1996,FRA,2.93E+11,2.81E+11,-11841799768
6201,1996,FRO,300190185,398974034,98783849
6202,1996,FSM,55049496,55287577,238081
6203,1996,GAB,866361294,3242117808,2375756514
6204,1996,GBR,2.78E+11,2.44E+11,-34179378018
6205,1996,GEO,1055510470,250845556,-804664914
6206,1996,GHA,2697737774,2016269158,-681468616
6207,1996,GIB,913861033,102073158,-811787875
6208,1996,GIN,758798552,838743320,79944768
6209,1996,GMB,281927439,165132682,-116794757
6210,1996,GNB,88398654,67482461,-20916193
6211,1996,GNQ,142673047,185142135,42469088
6212,1996,GRC,26964542547,11441976129,-15522566418
6213,1996,GRD,121855265,21711401,-100143864
6214,1996,GRL,320724662,478452485,157727823
6215,1996,GTM,3662440211,3288267252,-374172959
6216,1996,GUY,417509360,488564292,71054932
6217,1996,HKG,1.97E+11,1.31E+11,-66275139027
6218,1996,HND,2718880088,2644091652,-74788436
6219,1996,HRV,7940867112,4426177596,-3514689516
6220,1996,HTI,779294345,186545337,-592749008
6221,1996,HUN,18901910291,15490035298,-3411874993
6222,1996,IDN,42371089629,54647650720,12276561091
6223,1996,IND,37701543417,37005182475,-696360942
6224,1996,IOT,4140062,13659818,9519756
6225,1996,IRL,34603697734,45242200341,10638502607
6226,1996,IRN,10128113458,17980670223,7852556765
6227,1996,IRQ,285166623,37856062,-247310561
6228,1996,ISL,1845998364,1975663665,129665301
6229,1996,ISR,26611753372,19664738096,-6947015276
6230,1996,ITA,1.95E+11,2.48E+11,53377786377
6231,1996,JAM,2737701200,1961101928,-776599272
6232,1996,JOR,3136515477,806390320,-2330125157
6233,1996,JPN,3.23E+11,4.25E+11,1.02E+11
6234,1996,KAZ,4403113949,5251893348,848779399
6235,1996,KEN,2291648501,1683632519,-608015982
6236,1996,KGZ,856869482,503774300,-353095182
6237,1996,KHM,1312601620,249984780,-1062616840
6238,1996,KIR,51026172,8097298,-42928874
6239,1996,KNA,96918805,37924430,-58994375
6240,1996,KOR,1.36E+11,1.27E+11,-9253819269
6241,1996,KWT,6231146382,11406695833,5175549451
6242,1996,LAO,555248507,205705237,-349543270
6243,1996,LBN,5701144338,594654680,-5106489658
6244,1996,LBR,3066639497,1075256954,-1991382543
6245,1996,LBY,4881850997,10342276603,5460425606
6246,1996,LCA,240589729,113385995,-127203734
6247,1996,LKA,4087640054,3546970415,-540669639
6248,1996,LTU,4562629616,3759046762,-803582854
6249,1996,LVA,2967804320,2835503939,-132300381
6250,1996,MAC,2954931259,1939240706,-1015690553
6251,1996,MAR,9335577513,7355851937,-1979725576
6252,1996,MDA,1246493596,870195791,-376297805
6253,1996,MDG,744213426,663857038,-80356388
6254,1996,MDV,289528131,65591244,-223936887
6255,1996,MEX,79575174348,94617166861,15041992513
6256,1996,MHL,586439788,21345541,-565094247
6257,1996,MKD,1876547603,1105123226,-771424377
6258,1996,MLI,794346501,260526054,-533820447
6259,1996,MLT,3087827959,1574395707,-1513432252
6260,1996,MMR,2677297872,1205228372,-1472069500
6261,1996,MNG,479832299,302865675,-176966624
6262,1996,MNP,127407271,6738534,-120668737
6263,1996,MOZ,949635932,227672284,-721963648
6264,1996,MRT,529189523,623045913,93856390
6265,1996,MSR,18214460,27273280,9058820
6266,1996,MUS,2237898362,1638345272,-599553090
6267,1996,MWI,404525020,468128078,63603058
6268,1996,MYS,82353253207,86634514649,4281261442
6269,1996,NCL,896971846,546977122,-349994724
6270,1996,NER,332429143,89279236,-243149907
6271,1996,NGA,5919760500,16840615183,10920854683
6272,1996,NIC,1001562672,651497181,-350065491
6273,1996,NIU,40879780,1324681,-39555099
6274,1996,NLD,1.95E+11,1.73E+11,-21970382673
6275,1996,NOR,34511274199,50421711794,15910437595
6276,1996,NPL,614181176,389035630,-225145546
6277,1996,NRU,22514457,41343236,18828779
6278,1996,NZL,14139803465,14414778940,274975475
6279,1996,OMN,4015629570,5997425057,1981795487
6280,1996,PAK,8369805953,7591423281,-778382672
6281,1996,PAN,15855625748,3027636260,-12827989488
6282,1996,PCN,2342699,6020237,3677538
6283,1996,PER,7423394197,5956467365,-1466926832
6284,1996,PHL,35614341486,23497075916,-12117265570
6285,1996,PLW,47686902,35171336,-12515566
6286,1996,PNG,1617864568,2460578260,842713692
6287,1996,POL,37858810168,24197173829,-13661636339
6288,1996,PRK,1206186718,829121547,-377065171
6289,1996,PRT,35531614095,23126060270,-12405553825
6290,1996,PRY,4403750420,1334620231,-3069130189
6291,1996,PYF,759733990,147214208,-612519782
6292,1996,QAT,2282003788,4104906919,1822903131
6293,1996,ROU,11072331970,8083506311,-2988825659
6294,1996,RUS,53943186166,71933721652,17990535486
6295,1996,RWA,260313750,60451082,-199862668
6296,1996,SAU,31018896952,53708754290,22689857338
6297,1996,SDN,1190248524,448654012,-741594512
6298,1996,SEN,1827032304,627045970,-1199986334
6299,1996,SGP,1.25E+11,1.23E+11,-2198221127
6300,1996,SHN,37999818,6959829,-31039989
6301,1996,SLB,134040217,210848720,76808503
6302,1996,SLE,236529210,200656430,-35872780
6303,1996,SLV,2753032103,1943699281,-809332822
6304,1996,SOM,92996419,123047492,30051073
6305,1996,SPM,52150314,9695630,-42454684
6306,1996,STP,35164242,8347996,-26816246
6307,1996,SUR,605094367,506622058,-98472309
6308,1996,SVK,10531114339,8568091563,-1963022776
6309,1996,SVN,9696225470,8271448158,-1424777312
6310,1996,SWE,62904282948,82277969768,19373686820
6311,1996,SYC,297925875,60933572,-236992303
6312,1996,SYR,4251405947,3373051586,-878354361
6313,1996,TCA,60682883,20440522,-40242361
6314,1996,TCD,141576356,115525745,-26050611
6315,1996,TGO,680358287,419890204,-260468083
6316,1996,THA,69957977696,57118404975,-12839572721
6317,1996,TJK,209127833,245071225,35943392
6318,1996,TKL,5327643,5938331,610688
6319,1996,TKM,823727600,438479563,-385248037
6320,1996,TLS,3277239,545882,-2731357
6321,1996,TON,52731092,17716980,-35014112
6322,1996,TTO,1993810905,2535089540,541278635
6323,1996,TUN,7440579393,5573217659,-1867361734
6324,1996,TUR,40223472201,23068501980,-17154970221
6325,1996,TUV,4276543,1561719,-2714824
6326,1996,TWN,88508676251,1.20E+11,31688679023
6327,1996,TZA,1145957133,645762729,-500194404
6328,1996,UGA,870130321,597154161,-272976160
6329,1996,UKR,17251758792,15456436084,-1795322708
6330,1996,URY,3898324191,2724693973,-1173630218
6331,1996,USA,7.89E+11,6.45E+11,-1.43E+11
6332,1996,UZB,2883290736,1975606344,-907684392
6333,1996,VCT,163352500,95232935,-68119565
6334,1996,VEN,10899057416,23806356132,12907298716
6335,1996,VGB,392428857,117819302,-274609555
6336,1996,VNM,10087767039,6571182036,-3516585003
6337,1996,VUT,136457447,41343787,-95113660
6338,1996,WLF,15146860,490322,-14656538
6339,1996,WSM,124552810,59845429,-64707381
6340,1996,YEM,1776592738,1983590807,206998069
6341,1996,ZAF,26346788837,28400620977,2053832140
6342,1996,ZMB,977496294,1091693262,114196968
6343,1996,ZWE,2229293621,1832679847,-396613774
6344,1997,ABW,883464557,982379941,98915384
6345,1997,AGO,2245711089,4467903328,2222192239
6346,1997,AIA,43267323,6846994,-36420329
6347,1997,ALB,752476829,246362439,-506114390
6348,1997,AND,1006707004,46928264,-959778740
6349,1997,ANT,3062773464,1382722157,-1680051307
6350,1997,ARE,26974405027,25722028031,-1252376996
6351,1997,ARG,29250494332,27286879757,-1963614575
6352,1997,ARM,563400990,227513190,-335887800
6353,1997,ATG,280495581,86342448,-194153133
6354,1997,AUS,58779240352,58987549630,208309278
6355,1997,AUT,64281981172,54786801519,-9495179653
6356,1997,AZE,1294739084,772462616,-522276468
6357,1997,BDI,85572572,89060397,3487825
6358,1997,BEL,1.59E+11,1.61E+11,2170211512
6359,1997,BEN,985800016,302736698,-683063318
6360,1997,BFA,512783876,155048334,-357735542
6361,1997,BGD,6699179109,4583255524,-2115923585
6362,1997,BGR,5030499888,4812296518,-218203370
6363,1997,BHR,1881250720,1913294983,32044263
6364,1997,BHS,2275789747,707054804,-1568734943
6365,1997,BIH,2131993144,411908186,-1720084958
6366,1997,BLR,6583375968,5102390853,-1480985115
6367,1997,BLZ,365813091,253538308,-112274783
6368,1997,BMU,1253071458,279604579,-973466879
6369,1997,BOL,2633024019,1120706799,-1512317220
6370,1997,BRA,63026832488,56887731643,-6139100845
6371,1997,BRB,884162060,218888107,-665273953
6372,1997,BRN,3513087868,2756826745,-756261123
6373,1997,BTN,43381571,23170265,-20211306
6374,1997,CAF,108200262,174655747,66455485
6375,1997,CAN,2.02E+11,2.18E+11,16270924748
6376,1997,CCK,13739328,5808754,-7930574
6377,1997,CHE,84187396048,84943465676,756069628
6378,1997,CHL,18381860701,17428814340,-953046361
6379,1997,CHN,1.86E+11,2.77E+11,90541521743
6380,1997,CIV,3004574816,4823557149,1818982333
6381,1997,CMR,1569391612,2438020309,868628697
6382,1997,COD,830891803,1217114425,386222622
6383,1997,COG,748973990,2353100101,1604126111
6384,1997,COK,46693303,7906123,-38787180
6385,1997,COL,14421230408,12187557132,-2233673276
6386,1997,COM,161974743,13064073,-148910670
6387,1997,CPV,238200935,30700786,-207500149
6388,1997,CRI,4320540837,4643934561,323393724
6389,1997,CUB,2542227178,1646035072,-896192106
6390,1997,CXR,17368313,20307798,2939485
6391,1997,CYM,834324054,148332265,-685991789
6392,1997,CYP,4861429604,1311038130,-3550391474
6393,1997,CZE,27369452843,22371193607,-4998259236
6394,1997,DEU,4.36E+11,4.94E+11,58358847779
6395,1997,DJI,303295140,18132498,-285162642
6396,1997,DMA,189448408,90732947,-98715461
6397,1997,DNK,43129535899,44377804767,1248268868
6398,1997,DOM,6167253369,4792165253,-1375088116
6399,1997,DZA,8366086670,14895289594,6529202924
6400,1997,ECU,4938107135,6026856163,1088749028
6401,1997,EGY,18408866860,6351847726,-12057019134
6402,1997,ERI,209213639,35359687,-173853952
6403,1997,ESH,2061456,2739871,678415
6404,1997,ESP,1.24E+11,1.03E+11,-21097047918
6405,1997,EST,4418786918,3418295950,-1000490968
6406,1997,ETH,1287495960,642531870,-644964090
6407,1997,FIN,32040754263,39617998416,7577244153
6408,1997,FJI,817742950,512053355,-305689595
6409,1997,FLK,52913592,62288993,9375401
6410,1997,FRA,2.90E+11,2.85E+11,-4876059993
6411,1997,FRO,332818261,397489871,64671610
6412,1997,FSM,64164029,46566796,-17597233
6413,1997,GAB,1201300612,3519048254,2317747642
6414,1997,GBR,2.99E+11,2.71E+11,-28212005845
6415,1997,GEO,1236755815,401568722,-835187093
6416,1997,GHA,3055949803,1753861137,-1302088666
6417,1997,GIB,1571189401,94846319,-1476343082
6418,1997,GIN,774472083,820769980,46297897
6419,1997,GMB,323483209,168506435,-154976774
6420,1997,GNB,86531270,60938183,-25593087
6421,1997,GNQ,177448870,374499728,197050858
6422,1997,GRC,27539916028,10910878790,-16629037238
6423,1997,GRD,128797980,31336570,-97461410
6424,1997,GRL,379685064,413386787,33701723
6425,1997,GTM,4425342104,3872461503,-552880601
6426,1997,GUY,512369312,567918015,55548703
6427,1997,HKG,2.22E+11,1.36E+11,-85618449546
6428,1997,HND,3340514930,3227916427,-112598503
6429,1997,HRV,8937054675,4089310650,-4847744025
6430,1997,HTI,876315648,229694031,-646621617
6431,1997,HUN,22429237241,19231755241,-3197482000
6432,1997,IDN,45258931233,58850939117,13592007884
6433,1997,IND,38875427665,38508422848,-367004817
6434,1997,IOT,4281821,23306752,19024931
6435,1997,IRL,42570921504,52269103268,9698181764
6436,1997,IRN,12677490374,16812488806,4134998432
6437,1997,IRQ,783406479,3151699928,2368293449
6438,1997,ISL,1845252940,1928242440,82989500
6439,1997,ISR,26341484303,21799602605,-4541881698
6440,1997,ITA,1.97E+11,2.35E+11,37648382888
6441,1997,JAM,2900179098,1872408948,-1027770150
6442,1997,JOR,4048616060,1441650037,-2606966023
6443,1997,JPN,3.12E+11,4.35E+11,1.23E+11
6444,1997,KAZ,4583713476,5908231060,1324517584
6445,1997,KEN,3416498737,2210472699,-1206026038
6446,1997,KGZ,518688448,354872798,-163815650
6447,1997,KHM,1365679762,542868820,-822810942
6448,1997,KIR,38598196,36741219,-1856977
6449,1997,KNA,99369315,50701664,-48667651
6450,1997,KOR,1.33E+11,1.33E+11,309133946
6451,1997,KWT,6061991359,11934033201,5872041842
6452,1997,LAO,540599313,251340609,-289258704
6453,1997,LBN,7192351053,861003555,-6331347498
6454,1997,LBR,3284449529,1097959703,-2186489826
6455,1997,LBY,4917851510,9489765022,4571913512
6456,1997,LCA,237745568,102954160,-134791408
6457,1997,LKA,4830438432,4006641705,-823796727
6458,1997,LTU,5537040534,4205367972,-1331672562
6459,1997,LVA,4347265235,3036841320,-1310423915
6460,1997,MAC,3090638869,2181299731,-909339138
6461,1997,MAR,9334507701,7412356387,-1922151314
6462,1997,MDA,1444968616,1258673170,-186295446
6463,1997,MDG,779975239,664268681,-115706558
6464,1997,MDV,306051450,84098592,-221952858
6465,1997,MEX,99837485065,1.10E+11,9804821930
6466,1997,MHL,405900099,49361141,-356538958
6467,1997,MKD,1756339980,1154893554,-601446426
6468,1997,MLI,786677185,305869267,-480807918
6469,1997,MLT,3127939178,1527958861,-1599980317
6470,1997,MMR,2968712075,1108971780,-1859740295
6471,1997,MNG,530355779,481589734,-48766045
6472,1997,MNP,136274773,14840603,-121434170
6473,1997,MOZ,866263597,291558047,-574705550
6474,1997,MRT,529565835,642325208,112759373
6475,1997,MSR,29183532,15010693,-14172839
6476,1997,MUS,2231079765,1648856918,-582222847
6477,1997,MWI,462075803,561123639,99047836
6478,1997,MYS,82277975163,88365828533,6087853370
6479,1997,NCL,856347419,549578566,-306768853
6480,1997,NER,303867138,238060926,-65806212
6481,1997,NGA,6888465107,16831912103,9943446996
6482,1997,NIC,1187947257,802279323,-385667934
6483,1997,NIU,43367378,1149798,-42217580
6484,1997,NLD,2.06E+11,1.90E+11,-16453345831
6485,1997,NOR,36992993584,49210125301,12217131717
6486,1997,NPL,621710097,440271289,-181438808
6487,1997,NRU,22990297,28899354,5909057
6488,1997,NZL,13786033910,14173766185,387732275
6489,1997,OMN,4811266292,7859964538,3048698246
6490,1997,PAK,7481547751,7322458459,-159089292
6491,1997,PAN,16854184750,2775948151,-14078236599
6492,1997,PCN,2576999,4998145,2421146
6493,1997,PER,8004988124,6893420218,-1111567906
6494,1997,PHL,41436311101,28391326140,-13044984961
6495,1997,PLW,48272053,37413845,-10858208
6496,1997,PNG,1643975649,2073029006,429053357
6497,1997,POL,42360635753,25717088916,-16643546837
6498,1997,PRK,1320989807,1205151668,-115838139
6499,1997,PRT,36920703336,23325932268,-13594771068
6500,1997,PRY,4594175788,1491600457,-3102575331
6501,1997,PYF,757409408,195552972,-561856436
6502,1997,QAT,3483310228,5394020087,1910709859
6503,1997,ROU,10848193137,8586458426,-2261734711
6504,1997,RUS,65320827271,93526753849,28205926578
6505,1997,RWA,311093079,74869433,-236223646
6506,1997,SAU,31695878830,57616682279,25920803449
6507,1997,SDN,1608239751,563759910,-1044479841
6508,1997,SEN,1696409699,614249048,-1082160651
6509,1997,SGP,1.27E+11,1.23E+11,-4262719469
6510,1997,SHN,29747453,7723464,-22023989
6511,1997,SLB,135735217,222160510,86425293
6512,1997,SLE,202072006,194045048,-8026958
6513,1997,SLV,3286627399,2427950242,-858677157
6514,1997,SOM,113677060,38341271,-75335789
6515,1997,SPM,63369016,13860871,-49508145
6516,1997,STP,41596214,16995038,-24601176
6517,1997,SUR,482095242,518008764,35913522
6518,1997,SVK,12221859589,9393618991,-2828240598
6519,1997,SVN,9968609301,8120991529,-1847617772
6520,1997,SWE,63760448110,80997580422,17237132312
6521,1997,SYC,287079934,97269523,-189810411
6522,1997,SYR,3833765944,3665397213,-168368731
6523,1997,TCA,75316095,10437118,-64878977
6524,1997,TCD,120653013,136897720,16244707
6525,1997,TGO,833571981,444447949,-389124032
6526,1997,THA,61230782163,59892304664,-1338477499
6527,1997,TJK,349554172,280360441,-69193731
6528,1997,TKL,4912444,6815614,1903170
6529,1997,TKM,1114586673,1353086321,238499648
6530,1997,TLS,285011,1152179,867168
6531,1997,TON,53761324,16001371,-37759953
6532,1997,TTO,2942375983,2791404458,-150971525
6533,1997,TUN,7831293644,5586311312,-2244982332
6534,1997,TUR,45133246009,25628660416,-19504585593
6535,1997,TUV,6050528,627445,-5423083
6536,1997,TWN,1.10E+11,1.44E+11,33973681241
6537,1997,TZA,1642741574,750440289,-892301285
6538,1997,UGA,849396181,589880103,-259516078
6539,1997,UKR,18216508213,15328838185,-2887670028
6540,1997,URY,4394052429,2961297370,-1432755059
6541,1997,USA,8.66E+11,7.02E+11,-1.64E+11
6542,1997,UZB,3613444069,2788892204,-824551865
6543,1997,VCT,224012148,162391432,-61620716
6544,1997,VEN,15150017319,24574880331,9424863012
6545,1997,VGB,1460501952,239613473,-1220888479
6546,1997,VNM,11539559470,8519540125,-3020019345
6547,1997,VUT,145366399,72455168,-72911231
6548,1997,WLF,162315520,329629,-161985891
6549,1997,WSM,105360564,58639658,-46720906
6550,1997,YEM,1986309688,2322105964,335796276
6551,1997,ZAF,24135332139,28390689225,4255357086
6552,1997,ZMB,1112438082,1343376144,230938062
6553,1997,ZWE,2189642420,1980167892,-209474528
6554,1998,ABW,838527292,649103513,-189423779
6555,1998,AGO,1989769619,3625587893,1635818274
6556,1998,AIA,39185806,6116435,-33069371
6557,1998,ALB,809287743,265526877,-543760866
6558,1998,AND,972790105,48031225,-924758880
6559,1998,ANT,2964199664,869703728,-2094495936
6560,1998,ARE,27702242132,20665611269,-7036630863
6561,1998,ARG,30084626216,27202130022,-2882496194
6562,1998,ARM,440206797,227511033,-212695764
6563,1998,ATG,384880478,27146939,-357733539
6564,1998,AUS,57814581777,53724762287,-4089819490
6565,1998,AUT,67295421377,58312962655,-8982458722
6566,1998,AZE,1447252543,511965398,-935287145
6567,1998,BDI,117857469,68609566,-49247903
6568,1998,BEL,1.65E+11,1.75E+11,9950508916
6569,1998,BEN,1085207539,310816728,-774390811
6570,1998,BFA,699217741,223993099,-475224642
6571,1998,BGD,6840930742,5065103892,-1775826850
6572,1998,BGR,5413028056,4624146018,-788882038
6573,1998,BHR,2176138420,2160669546,-15468874
6574,1998,BHS,2473830041,563982733,-1909847308
6575,1998,BIH,2293608358,536709181,-1756899177
6576,1998,BLR,8028649539,7043223723,-985425816
6577,1998,BLZ,336345060,285694371,-50650689
6578,1998,BMU,1143614956,148254351,-995360605
6579,1998,BOL,2966729796,1108432481,-1858297315
6580,1998,BRA,60100328074,53816273467,-6284054607
6581,1998,BRB,750958131,207039298,-543918833
6582,1998,BRN,1950044609,2027757169,77712560
6583,1998,BTN,38095372,15228846,-22866526
6584,1998,CAF,114733875,230827251,116093376
6585,1998,CAN,2.07E+11,2.20E+11,13422708931
6586,1998,CCK,12992219,4862175,-8130044
6587,1998,CHE,88891492032,87170154183,-1721337849
6588,1998,CHL,16744761400,15670179998,-1074581402
6589,1998,CHN,1.82E+11,2.81E+11,98841748290
6590,1998,CIV,3148838205,5187631721,2038793516
6591,1998,CMR,1449285737,1956924358,507638621
6592,1998,COD,762321231,1062182258,299861027
6593,1998,COG,884109099,1463574066,579464967
6594,1998,COK,52670640,7501609,-45169031
6595,1998,COL,13774016134,11966375765,-1807640369
6596,1998,COM,163920732,11174296,-152746436
6597,1998,CPV,237098711,30697355,-206401356
6598,1998,CRI,6159440845,6301815131,142374286
6599,1998,CUB,2677292998,1330818415,-1346474583
6600,1998,CXR,13838855,25636375,11797520
6601,1998,CYM,1067124752,179253884,-887870868
6602,1998,CYP,5522711094,1218331529,-4304379565
6603,1998,CZE,28707289484,26487914685,-2219374799
6604,1998,DEU,4.60E+11,5.26E+11,65715357826
6605,1998,DJI,422422369,24076052,-398346317
6606,1998,DMA,189806539,90261464,-99545075
6607,1998,DNK,43397869277,43086659149,-311210128
6608,1998,DOM,6694434914,4855184105,-1839250809
6609,1998,DZA,9862108790,11411766252,1549657462
6610,1998,ECU,5614533643,5053260159,-561273484
6611,1998,EGY,19406367557,5268565515,-14137802042
6612,1998,ERI,331485364,24329895,-307155469
6613,1998,ESH,1872554,211410,-1661144
6614,1998,ESP,1.37E+11,1.08E+11,-29197446756
6615,1998,EST,4844854807,3552638680,-1292216127
6616,1998,ETH,1741262060,646631800,-1094630260
6617,1998,FIN,32990913956,41564904021,8573990065
6618,1998,FJI,750794290,522749008,-228045282
6619,1998,FLK,87701632,100126378,12424746
6620,1998,FRA,3.02E+11,3.02E+11,18661886
6621,1998,FRO,348566028,409812044,61246016
6622,1998,FSM,72008848,42292711,-29716137
6623,1998,GAB,1121369604,2393982966,1272613362
6624,1998,GBR,3.08E+11,2.63E+11,-44929416723
6625,1998,GEO,1131047108,331044411,-800002697
6626,1998,GHA,3113221597,1681605247,-1431616350
6627,1998,GIB,1152764913,66673495,-1086091418
6628,1998,GIN,703392371,835850181,132457810
6629,1998,GMB,323885229,147190941,-176694288
6630,1998,GNB,67933745,62174741,-5759004
6631,1998,GNQ,227350785,428419045,201068260
6632,1998,GRC,28962319124,10344732622,-18617586502
6633,1998,GRD,156005648,41691306,-114314342
6634,1998,GRL,386973223,371459995,-15513228
6635,1998,GTM,5254475088,4140699513,-1113775575
6636,1998,GUY,448215608,519555310,71339702
6637,1998,HKG,1.95E+11,1.23E+11,-71330603418
6638,1998,HND,3971273131,3596895892,-374377239
6639,1998,HRV,8211665352,4397665477,-3813999875
6640,1998,HTI,920382765,307591206,-612791559
6641,1998,HUN,26932403017,23121435826,-3810967191
6642,1998,IDN,26090065219,55610539886,29520474667
6643,1998,IND,40932179604,36865646709,-4066532895
6644,1998,IOT,11834043,7987282,-3846761
6645,1998,IRL,43632027832,61245077812,17613049980
6646,1998,IRN,11543206776,11634208775,91001999
6647,1998,IRQ,1310855847,4831507670,3520651823
6648,1998,ISL,2180098418,2055181012,-124917406
6649,1998,ISR,26933938670,22780430027,-4153508643
6650,1998,ITA,2.06E+11,2.38E+11,32000745023
6651,1998,JAM,2704215192,1821593921,-882621271
6652,1998,JOR,3955010427,1383025305,-2571985122
6653,1998,JPN,2.58E+11,4.07E+11,1.49E+11
6654,1998,KAZ,4813889472,5200868145,386978673
6655,1998,KEN,3263561709,2178420232,-1085141477
6656,1998,KGZ,620300183,392425853,-227874330
6657,1998,KHM,1283196951,751104057,-532092894
6658,1998,KIR,34686203,27336998,-7349205
6659,1998,KNA,108803845,48231012,-60572833
6660,1998,KOR,83640557952,1.30E+11,45884550451
6661,1998,KWT,7161689114,8999688165,1837999051
6662,1998,LAO,501166930,195843532,-305323398
6663,1998,LBN,6651808751,822449125,-5829359626
6664,1998,LBR,5502673003,1210034606,-4292638397
6665,1998,LBY,4352699042,6838432435,2485733393
6666,1998,LCA,240921321,95464739,-145456582
6667,1998,LKA,4875980978,4146274169,-729706809
6668,1998,LTU,5508603690,3972219708,-1536383982
6669,1998,LVA,4413044532,2765928113,-1647116419
6670,1998,MAC,3012113060,2177833655,-834279405
6671,1998,MAR,10054263541,7753941266,-2300322275
6672,1998,MDA,1288186590,983916724,-304269866
6673,1998,MDG,847614820,727341666,-120273154
6674,1998,MDV,327574291,86508693,-241065598
6675,1998,MEX,1.12E+11,1.17E+11,5245894015
6676,1998,MHL,80100099,83725524,3625425
6677,1998,MKD,1860641594,1211470347,-649171247
6678,1998,MLI,860371851,302004312,-558367539
6679,1998,MLT,3637563348,1842824629,-1794738719
6680,1998,MMR,2409042952,1044511186,-1364531766
6681,1998,MNG,530108440,379217786,-150890654
6682,1998,MNP,129612336,16902146,-112710190
6683,1998,MOZ,791626469,249127811,-542498658
6684,1998,MRT,552193523,563564214,11370691
6685,1998,MSR,15489217,2973946,-12515271
6686,1998,MUS,2147326316,1724610197,-422716119
6687,1998,MWI,438632670,466271084,27638414
6688,1998,MYS,60825648678,82143047380,21317398702
6689,1998,NCL,785068419,418928954,-366139465
6690,1998,NER,386232131,268116029,-118116102
6691,1998,NGA,7033226158,11420897878,4387671720
6692,1998,NIC,1791850484,832997717,-958852767
6693,1998,NIU,12182357,7870565,-4311792
6694,1998,NLD,2.10E+11,1.76E+11,-34245194554
6695,1998,NOR,39073412261,40536258592,1462846331
6696,1998,NPL,638371384,481186736,-157184648
6697,1998,NRU,17568129,24619410,7051281
6698,1998,NZL,11813740705,12742560844,928820139
6699,1998,OMN,5487942913,5787459768,299516855
6700,1998,PAK,6631069111,7270922501,639853390
6701,1998,PAN,16447406572,2324083936,-14123322636
6702,1998,PCN,4681817,1704632,-2977185
6703,1998,PER,7875346158,5617265780,-2258080378
6704,1998,PHL,33781013882,32656164312,-1124849570
6705,1998,PLW,38532116,30558688,-7973428
6706,1998,PNG,1178428593,1573131388,394702795
6707,1998,POL,45584535974,27395043188,-18189492786
6708,1998,PRK,1063772624,922973757,-140798867
6709,1998,PRT,39225103233,23906045390,-15319057843
6710,1998,PRY,4099389714,1322082200,-2777307514
6711,1998,PYF,810623150,163855487,-646767663
6712,1998,QAT,2997889881,4754994142,1757104261
6713,1998,ROU,11870431002,8618342359,-3252088643
6714,1998,RUS,53267471462,80398712761,27131241299
6715,1998,RWA,252747967,68636213,-184111754
6716,1998,SAU,35822031478,40247132913,4425101435
6717,1998,SDN,1921223899,607392121,-1313831778
6718,1998,SEN,1620838126,738664753,-882173373
6719,1998,SGP,1.00E+11,1.08E+11,7994249218
6720,1998,SHN,32938127,7450809,-25487318
6721,1998,SLB,111629959,196078570,84448611
6722,1998,SLE,154710785,114056019,-40654766
6723,1998,SLV,3739703359,2499898403,-1239804956
6724,1998,SOM,132617014,53825668,-78791346
6725,1998,SPM,50714852,14826676,-35888176
6726,1998,STP,46105981,14298785,-31807196
6727,1998,SUR,527440974,526294977,-1145997
6728,1998,SVK,12461757324,10668363980,-1793393344
6729,1998,SVN,10308217121,8802755349,-1505461772
6730,1998,SWE,66535359615,83865871005,17330511390
6731,1998,SYC,283764810,108517328,-175247482
6732,1998,SYR,4422974477,2894096801,-1528877676
6733,1998,TCA,76480800,8375324,-68105476
6734,1998,TCD,115895327,133803207,17907880
6735,1998,TGO,753752268,406004357,-347747911
6736,1998,THA,42367483899,56817155000,14449671101
6737,1998,TJK,330410079,271430733,-58979346
6738,1998,TKL,8767401,9921627,1154226
6739,1998,TKM,819033785,323177701,-495856084
6740,1998,TLS,196355,496198,299843
6741,1998,TON,56073540,15348636,-40724904
6742,1998,TTO,2869111849,2523983665,-345128184
6743,1998,TUN,8494129561,5915083948,-2579045613
6744,1998,TUR,42843056693,26381743508,-16461313185
6745,1998,TUV,7205558,425533,-6780025
6746,1998,TWN,1.01E+11,1.35E+11,33657104598
6747,1998,TZA,1885549788,788845517,-1096704271
6748,1998,UGA,965359039,617130939,-348228100
6749,1998,UKR,15540410783,14255069383,-1285341400
6750,1998,URY,4544352185,3049846710,-1494505475
6751,1998,USA,9.11E+11,7.03E+11,-2.07E+11
6752,1998,UZB,2523692436,1912030900,-611661536
6753,1998,VCT,460745811,135516064,-325229747
6754,1998,VEN,15830323661,18824708731,2994385070
6755,1998,VGB,1486093554,132243793,-1353849761
6756,1998,VNM,10650081608,8899886093,-1750195515
6757,1998,VUT,114438158,77795446,-36642712
6758,1998,WLF,52966323,470228,-52496095
6759,1998,WSM,107117554,54407032,-52710522
6760,1998,YEM,1856563698,1570515485,-286048213
6761,1998,ZAF,24332552213,26768782223,2436230010
6762,1998,ZMB,927247405,927796460,549055
6763,1998,ZWE,1789113012,1675841759,-113271253
6764,1999,ABW,624323627,896908576,272584949
6765,1999,AGO,1974687166,4548886570,2574199404
6766,1999,AIA,39166000,5140376,-34025624
6767,1999,ALB,1037111621,271334447,-765777174
6768,1999,AND,983986914,45092674,-938894240
6769,1999,ANT,3598050265,1178048616,-2420001649
6770,1999,ARE,29686123401,27847104269,-1839019132
6771,1999,ARG,24712917390,24043683417,-669233973
6772,1999,ARM,690978104,210561984,-480416120
6773,1999,ATG,755193126,41419862,-713773264
6774,1999,AUS,60434508172,53283361184,-7151146988
6775,1999,AUT,68802926077,58366998827,-10435927250
6776,1999,AZE,1241064391,992640983,-248423408
6777,1999,BDI,125377834,59309106,-66068728
6778,1999,BEL,1.61E+11,1.76E+11,14576709670
6779,1999,BEN,1121955560,301955197,-820000363
6780,1999,BFA,620236078,167907681,-452328397
6781,1999,BGD,5807451777,4970880822,-836570955
6782,1999,BGR,5651773589,4098072185,-1553701404
6783,1999,BHR,2295344325,2354963680,59619355
6784,1999,BHS,2809363518,696179013,-2113184505
6785,1999,BIH,2364841165,641102170,-1723738995
6786,1999,BLR,6010894670,5939683462,-71211208
6787,1999,BLZ,326291884,344059862,17767978
6788,1999,BMU,2351452856,160057786,-2191395070
6789,1999,BOL,1982480133,1051531237,-930948896
6790,1999,BRA,50225374998,50594408552,369033554
6791,1999,BRB,782211970,225923416,-556288554
6792,1999,BRN,1291497567,2220860517,929362950
6793,1999,BTN,33586609,21150325,-12436284
6794,1999,CAF,103950704,207937536,103986832
6795,1999,CAN,2.23E+11,2.43E+11,20653215102
6796,1999,CCK,11832762,4517641,-7315121
6797,1999,CHE,86581903085,88504465771,1922562686
6798,1999,CHL,13736347712,16185199006,2448851294
6799,1999,CHN,2.02E+11,3.12E+11,1.10E+11
6800,1999,CIV,3249964579,4930307600,1680343021
6801,1999,CMR,1302765043,1948686259,645921216
6802,1999,COD,494823513,1132127762,637304249
6803,1999,COG,611649430,1766800348,1155150918
6804,1999,COK,56548263,7223027,-49325236
6805,1999,COL,9800972476,12299137783,2498165307
6806,1999,COM,158769498,21334868,-137434630
6807,1999,CPV,276192433,21167717,-255024716
6808,1999,CRI,6355677903,7511847265,1156169362
6809,1999,CUB,3947879295,1498938080,-2448941215
6810,1999,CXR,13084242,17813483,4729241
6811,1999,CYM,1146260400,243710670,-902549730
6812,1999,CYP,4707921910,1231047569,-3476874341
6813,1999,CZE,27893675650,26264061008,-1629614642
6814,1999,DEU,4.61E+11,5.25E+11,63328220962
6815,1999,DJI,465941627,17480659,-448460968
6816,1999,DMA,191589937,116245024,-75344913
6817,1999,DNK,42970034816,44583362620,1613327804
6818,1999,DOM,7195475366,4624242870,-2571232496
6819,1999,DZA,9503886867,11470453059,1966566192
6820,1999,ECU,3174797949,5428282474,2253484525
6821,1999,EGY,19164651126,5565777292,-13598873834
6822,1999,ERI,179418540,11111788,-168306752
6823,1999,ESH,1497812,751530,-746282
6824,1999,ESP,1.48E+11,1.09E+11,-38947789007
6825,1999,EST,4385558333,3375879803,-1009678530
6826,1999,ETH,1540399485,485329344,-1055070141
6827,1999,FIN,34107576948,40979438546,6871861598
6828,1999,FJI,897207114,581621856,-315585258
6829,1999,FLK,40632116,106819689,66187573
6830,1999,FRA,3.05E+11,2.96E+11,-8238811357
6831,1999,FRO,441811773,400885347,-40926426
6832,1999,FSM,59874753,51750047,-8124706
6833,1999,GAB,728647422,2640983037,1912335615
6834,1999,GBR,3.10E+11,2.55E+11,-54280938640
6835,1999,GEO,856743306,406986549,-449756757
6836,1999,GHA,2768423922,1782491109,-985932813
6837,1999,GIB,1523095825,91026242,-1432069583
6838,1999,GIN,696880917,803823167,106942250
6839,1999,GMB,341925145,89047683,-252877462
6840,1999,GNB,71813368,64517976,-7295392
6841,1999,GNQ,368025669,659642246,291616577
6842,1999,GRC,29638467931,10674480116,-18963987815
6843,1999,GRD,171275103,47920066,-123355037
6844,1999,GRL,387563751,407527625,19963874
6845,1999,GTM,5118615285,4220109549,-898505736
6846,1999,GUY,461757731,520258369,58500638
6847,1999,HKG,1.94E+11,1.30E+11,-63611097729
6848,1999,HND,4069109223,3637524408,-431584815
6849,1999,HRV,7316671019,4243789424,-3072881595
6850,1999,HTI,1006014441,328355586,-677658855
6851,1999,HUN,27840028800,25439129527,-2400899273
6852,1999,IDN,28143258143,57621111113,29477852970
6853,1999,IND,48898774554,38818268293,-10080506261
6854,1999,IOT,23010529,38887097,15876568
6855,1999,IRL,47247412340,71899415869,24652003529
6856,1999,IRN,10911930519,15893127597,4981197078
6857,1999,IRQ,1582660851,10695122221,9112461370
6858,1999,ISL,2412259730,2098123998,-314135732
6859,1999,ISR,29660745026,25175739634,-4485005392
6860,1999,ITA,2.05E+11,2.30E+11,25407439476
6861,1999,JAM,2674209115,1629955467,-1044253648
6862,1999,JOR,3835311796,1486689125,-2348622671
6863,1999,JPN,2.93E+11,4.40E+11,1.47E+11
6864,1999,KAZ,3811517905,6932393949,3120876044
6865,1999,KEN,2840282488,1968251380,-872031108
6866,1999,KGZ,484735439,282864996,-201870443
6867,1999,KHM,1458965889,1120246324,-338719565
6868,1999,KIR,39691979,7196377,-32495602
6869,1999,KNA,110313715,47709151,-62604564
6870,1999,KOR,1.14E+11,1.45E+11,31888184820
6871,1999,KWT,5247366582,12273072934,7025706352
6872,1999,LAO,562043865,226506919,-335536946
6873,1999,LBN,5922226556,858527259,-5063699297
6874,1999,LBR,3193339919,636773956,-2556565963
6875,1999,LBY,3811885780,8492409343,4680523563
6876,1999,LCA,268615301,99619759,-168995542
6877,1999,LKA,5662644530,4540138216,-1122506314
6878,1999,LTU,4842641581,3376134483,-1466507098
6879,1999,LUX,10356437916,5721397626,-4635040290
6880,1999,LVA,4480871218,2509827514,-1971043704
6881,1999,MAC,2560190746,2131891257,-428299489
6882,1999,MAR,10535000819,8014116024,-2520884795
6883,1999,MDA,919045903,698493980,-220551923
6884,1999,MDG,909217207,770023508,-139193699
6885,1999,MDV,311024118,111908610,-199115508
6886,1999,MEX,1.25E+11,1.35E+11,9678423905
6887,1999,MHL,411525257,47465728,-364059529
6888,1999,MKD,2163870363,1028606559,-1135263804
6889,1999,MLI,833260750,257870367,-575390383
6890,1999,MLT,3843789471,1849520344,-1994269127
6891,1999,MMR,2272141917,1257471200,-1014670717
6892,1999,MNG,479904655,365190195,-114714460
6893,1999,MNP,133333348,12827406,-120505942
6894,1999,MOZ,1205819691,273210579,-932609112
6895,1999,MRT,508980494,611812093,102831599
6896,1999,MSR,17852932,2869450,-14983482
6897,1999,MUS,2231074878,1617290932,-613783946
6898,1999,MWI,523601510,577845190,54243680
6899,1999,MYS,68008253658,92998152436,24989898778
6900,1999,NCL,858450280,391726580,-466723700
6901,1999,NER,391265408,288986751,-102278657
6902,1999,NGA,6836266001,14586450587,7750184586
6903,1999,NIC,1590491543,836254499,-754237044
6904,1999,NIU,4736479,782062,-3954417
6905,1999,NLD,2.12E+11,1.77E+11,-35379085691
6906,1999,NOR,34397558158,46537400964,12139842806
6907,1999,NPL,765310574,591726512,-173584062
6908,1999,NRU,31063177,44968668,13905491
6909,1999,NZL,13668104912,12787747404,-880357508
6910,1999,OMN,4728934588,6874828153,2145893565
6911,1999,PAK,6459642560,7382162587,922520027
6912,1999,PAN,17264975961,2358370258,-14906605703
6913,1999,PCN,3487008,15928663,12441655
6914,1999,PER,6407252071,5928870736,-478381335
6915,1999,PHL,38211800180,37915041952,-296758228
6916,1999,PLW,35063453,37625783,2562330
6917,1999,PNG,1050154909,1944160346,894005437
6918,1999,POL,45462279317,26907315528,-18554963789
6919,1999,PRK,1148878613,858992497,-289886116
6920,1999,PRT,41061324536,24102932377,-16958392159
6921,1999,PRY,2796937225,1058863700,-1738073525
6922,1999,PYF,770272190,202410174,-567862016
6923,1999,QAT,1963015094,6308228631,4345213537
6924,1999,ROU,10342024083,8903578252,-1438445831
6925,1999,RUS,35708357903,83453239079,47744881176
6926,1999,RWA,212437864,41890358,-170547506
6927,1999,SAU,32295568400,46766323489,14470755089
6928,1999,SDN,1509501895,647177455,-862324440
6929,1999,SEN,1720279304,695497522,-1024781782
6930,1999,SGP,1.09E+11,1.13E+11,4043856439
6931,1999,SHN,40896611,8452180,-32444431
6932,1999,SLB,133322455,154719504,21397049
6933,1999,SLE,145995397,85187125,-60808272
6934,1999,SLV,3858182061,2547026013,-1311156048
6935,1999,SOM,251784252,85667300,-166116952
6936,1999,SPM,54769550,10845996,-43923554
6937,1999,STP,44174969,15941986,-28232983
6938,1999,SUR,428729078,560134665,131405587
6939,1999,SVK,11137990540,10372812435,-765178105
6940,1999,SVN,9992414226,8414737054,-1577677172
6941,1999,SWE,65153354209,80249221093,15095866884
6942,1999,SYC,336301053,144893136,-191407917
6943,1999,SYR,3860848013,3509616985,-351231028
6944,1999,TCA,114580314,11991786,-102588528
6945,1999,TCD,91932017,109611667,17679650
6946,1999,TGO,828987766,399712757,-429275009
6947,1999,THA,48989209535,61757796727,12768587192
6948,1999,TJK,297847854,265910770,-31937084
6949,1999,TKL,8545223,16562575,8017352
6950,1999,TKM,945435720,1380035317,434599597
6951,1999,TLS,99948,335733,235785
6952,1999,TON,47907411,18900337,-29007074
6953,1999,TTO,2555335838,3016307006,460971168
6954,1999,TUN,8457696507,6094826586,-2362869921
6955,1999,TUR,38220924097,26208799046,-12012125051
6956,1999,TUV,7146784,1736380,-5410404
6957,1999,TWN,1.11E+11,1.46E+11,35328720481
6958,1999,TZA,1604772497,702795993,-901976504
6959,1999,UGA,840926181,597936183,-242989998
6960,1999,UKR,12097396783,12520565267,423168484
6961,1999,URY,4035033537,2496039981,-1538993556
6962,1999,USA,1.02E+12,7.10E+11,-3.06E+11
6963,1999,UZB,1924459071,1656828334,-267630737
6964,1999,VCT,313021119,172347670,-140673449
6965,1999,VEN,13761750330,21096600245,7334849915
6966,1999,VGB,2508490448,166940342,-2341550106
6967,1999,VNM,11052778736,10487165594,-565613142
6968,1999,VUT,164250733,63932004,-100318729
6969,1999,WLF,290021048,247548,-289773500
6970,1999,WSM,118502742,51249537,-67253205
6971,1999,YEM,1923098101,2301969539,378871438
6972,1999,ZAF,23627817883,28515693430,4887875547
6973,1999,ZMB,759327925,865701107,106373182
6974,1999,ZWE,1601840492,1801518266,199677774
6975,2000,ABW,941666910,1856268751,914601841
6976,2000,AGO,1954441123,7713066319,5758625196
6977,2000,AIA,56674336,4359195,-52315141
6978,2000,ALB,1009573676,279802947,-729770729
6979,2000,AND,932096237,41893209,-890203028
6980,2000,ANT,4346853820,1872647651,-2474206169
6981,2000,ARE,33321145026,37254203989,3933058963
6982,2000,ARG,24108109408,26660231640,2552122232
6983,2000,ARM,674248938,298511743,-375737195
6984,2000,ASM,104375617,16700206,-87675411
6985,2000,ATA,4703879,3215300,-1488579
6986,2000,ATG,871168879,128190927,-742977952
6987,2000,AUS,68292693025,65336424396,-2956268629
6988,2000,AUT,70130134994,61876427853,-8253707141
6989,2000,AZE,1605802688,1494358781,-111443907
6990,2000,BDI,139360797,49915534,-89445263
6991,2000,BEL,1.72E+11,1.84E+11,12339322125
6992,2000,BEN,1310654816,281331608,-1029323208
6993,2000,BFA,545071056,232888755,-312182301
6994,2000,BGD,7667360372,6433212721,-1234147651
6995,2000,BGR,6616217385,4595066809,-2021150576
6996,2000,BHR,2956797775,3009809248,53011473
6997,2000,BHS,3554746757,904527093,-2650219664
6998,2000,BIH,2373612908,701007742,-1672605166
6999,2000,BLR,7828581299,7378158962,-450422337
7000,2000,BLZ,430983587,316285348,-114698239
7001,2000,BMU,2932863948,198928459,-2733935489
7002,2000,BOL,1691100686,1258601024,-432499662
7003,2000,BRA,57898058510,57703237860,-194820650
7004,2000,BRB,2350035125,218337837,-2131697288
7005,2000,BRN,1410039646,3477758856,2067719210
7006,2000,BTN,29227586,24065853,-5161733
7007,2000,BWA,1866923879,1067212046,-799711833
7008,2000,CAF,81601517,225787307,144185790
7009,2000,CAN,2.52E+11,2.84E+11,32198045087
7010,2000,CCK,6822051,1340368,-5481683
7011,2000,CHE,92941615135,88468201449,-4473413686
7012,2000,CHL,17007865281,19357374201,2349508920
7013,2000,CHN,2.57E+11,3.90E+11,1.33E+11
7014,2000,CIV,3195754064,4377009920,1181255856
7015,2000,CMR,1592966555,2492434108,899467553
7016,2000,COD,610645969,1146218583,535572614
7017,2000,COG,721848712,2975064696,2253215984
7018,2000,COK,29690299,8909284,-20781015
7019,2000,COL,10812560718,13991626088,3179065370
7020,2000,COM,53897797,16324764,-37573033
7021,2000,CPV,270930848,18793913,-252136935
7022,2000,CRI,5541967708,7193555408,1651587700
7023,2000,CUB,4327595695,1462784054,-2864811641
7024,2000,CXR,16298661,17850865,1552204
7025,2000,CYM,1209302295,257807387,-951494908
7026,2000,CYP,6614416119,1145103020,-5469313099
7027,2000,CZE,32545810460,29062789652,-3483020808
7028,2000,DEU,4.99E+11,5.43E+11,43699653760
7029,2000,DJI,483013198,11916532,-471096666
7030,2000,DMA,221548108,99947579,-121600529
7031,2000,DNK,42521373981,45386059928,2864685947
7032,2000,DOM,8559937125,4803549225,-3756387900
7033,2000,DZA,9470941487,18417424249,8946482762
7034,2000,ECU,3720166925,6121035729,2400868804
7035,2000,EGY,18610839170,6339635153,-12271204017
7036,2000,ERI,137179240,12496248,-124682992
7037,2000,ESH,2845292,10139672,7294380
7038,2000,ESP,1.60E+11,1.11E+11,-48892406851
7039,2000,EST,5619180694,4945974122,-673206572
7040,2000,ETH,1389685320,526214786,-863470534
7041,2000,FIN,37622493011,45139156121,7516663110
7042,2000,FJI,690125815,561512671,-128613144
7043,2000,FLK,60406036,85865144,25459108
7044,2000,FRA,3.34E+11,2.95E+11,-38721153524
7045,2000,FRO,472662516,398800417,-73862099
7046,2000,FSM,86192134,67737317,-18454817
7047,2000,GAB,808337822,3592030302,2783692480
7048,2000,GBR,3.63E+11,2.96E+11,-67130812353
7049,2000,GEO,949108161,646567876,-302540285
7050,2000,GHA,2848299702,1936891643,-911408059
7051,2000,GIB,2069836723,56550065,-2013286658
7052,2000,GIN,790320240,877731708,87411468
7053,2000,GMB,306205493,46110609,-260094884
7054,2000,GNB,88099928,123689219,35589291
7055,2000,GNQ,287782890,1199566330,911783440
7056,2000,GRC,32521831379,10985141198,-21536690181
7057,2000,GRD,197096464,59343163,-137753301
7058,2000,GRL,372466751,403478168,31011417
7059,2000,GTM,5541969805,4737124180,-804845625
7060,2000,GUM,482598144,120894827,-361703317
7061,2000,GUY,516968093,568448143,51480050
7062,2000,HKG,2.31E+11,2.02E+11,-28865635845
7063,2000,HND,4384102837,3960287780,-423815057
7064,2000,HRV,7437119571,4351001367,-3086118204
7065,2000,HTI,972908070,320146690,-652761380
7066,2000,HUN,33408452330,28811590556,-4596861774
7067,2000,IDN,38133626392,69246030606,31112404214
7068,2000,IND,44257516622,45615331117,1357814495
7069,2000,IOT,40250476,57347780,17097304
7070,2000,IRL,53191229141,77191815616,24000586475
7071,2000,IRN,14568096374,30952693663,16384597289
7072,2000,IRQ,2819895376,15631033014,12811137638
7073,2000,ISL,2752930425,2110322808,-642607617
7074,2000,ISR,33447779263,31007494894,-2440284369
7075,2000,ITA,2.22E+11,2.36E+11,13992496250
7076,2000,JAM,3052802852,1606922783,-1445880069
7077,2000,JOR,3984574041,1430794818,-2553779223
7078,2000,JPN,3.60E+11,5.00E+11,1.40E+11
7079,2000,KAZ,5244609476,11459189830,6214580354
7080,2000,KEN,3076564466,1905819489,-1170744977
7081,2000,KGZ,584352861,432089343,-152263518
7082,2000,KHM,1987258645,1744303950,-242954695
7083,2000,KIR,40210218,21009330,-19200888
7084,2000,KNA,136715430,77563521,-59151909
7085,2000,KOR,1.54E+11,1.76E+11,21591977905
7086,2000,KWT,6836467877,18610425678,11773957801
7087,2000,LAO,604525985,355529899,-248996086
7088,2000,LBN,5864555226,962743713,-4901811513
7089,2000,LBR,4948963443,732491135,-4216472308
7090,2000,LBY,3602963965,13168392928,9565428963
7091,2000,LCA,349703898,87448570,-262255328
7092,2000,LKA,6456570371,5339894893,-1116675478
7093,2000,LSO,571373605,169710812,-401662793
7094,2000,LTU,6392065777,4191848508,-2200217269
7095,2000,LUX,11036014029,6649562232,-4386451797
7096,2000,LVA,5295599709,2945137657,-2350462052
7097,2000,MAC,2682293895,2515817725,-166476170
7098,2000,MAR,11638852983,7944157091,-3694695892
7099,2000,MDA,947800160,806832167,-140967993
7100,2000,MDG,1064388855,919469116,-144919739
7101,2000,MDV,386824588,178711913,-208112675
7102,2000,MEX,1.55E+11,1.64E+11,9194556430
7103,2000,MHL,790017183,32560436,-757456747
7104,2000,MKD,2335224897,1144412556,-1190812341
7105,2000,MLI,845636274,257140893,-588495381
7106,2000,MLT,4606431595,2245173660,-2361257935
7107,2000,MMR,2737578127,1948654932,-788923195
7108,2000,MNG,586501093,459865045,-126636048
7109,2000,MNP,226361689,12059269,-214302420
7110,2000,MOZ,1247813534,437685007,-810128527
7111,2000,MRT,538524115,540964061,2439946
7112,2000,MSR,21940526,2538321,-19402205
7113,2000,MUS,2174961559,1628102112,-546859447
7114,2000,MWI,471511920,529090623,57578703
7115,2000,MYS,84999768457,1.16E+11,30608364955
7116,2000,MYT,127316474,4227905,-123088569
7117,2000,NAM,1519687843,1070094504,-449593339
7118,2000,NCL,817576173,604627309,-212948864
7119,2000,NER,401177354,468765510,67588156
7120,2000,NGA,8300321372,22558464166,14258142794
7121,2000,NIC,1825572724,981950420,-843622304
7122,2000,NIU,10015727,3629914,-6385813
7123,2000,NLD,2.25E+11,2.06E+11,-19282444695
7124,2000,NOR,35751691510,63836837480,28085145970
7125,2000,NPL,917932808,747651173,-170281635
7126,2000,NRU,57418794,34461388,-22957406
7127,2000,NZL,13295228482,13977130148,681901666
7128,2000,OMN,4867797047,10898487981,6030690934
7129,2000,PAK,7038118010,8419215468,1381097458
7130,2000,PAN,16973047457,2467660360,-14505387097
7131,2000,PCN,5786730,2843650,-2943080
7132,2000,PER,7102948059,6763155489,-339792570
7133,2000,PHL,46329684045,46031079210,-298604835
7134,2000,PLW,51957296,31489951,-20467345
7135,2000,PNG,1094618623,2055859020,961240397
7136,2000,POL,48809379654,30853285300,-17956094354
7137,2000,PRK,1705639198,1067391770,-638247428
7138,2000,PRT,40969102834,24280068672,-16689034162
7139,2000,PRY,3032070641,1579541063,-1452529578
7140,2000,PSE,147009120,50669100,-96340020
7141,2000,PYF,841891903,197772922,-644118981
7142,2000,QAT,2949091121,11810194223,8861103102
7143,2000,ROU,12963929916,10601234748,-2362695168
7144,2000,RUS,42754101812,1.14E+11,71144890564
7145,2000,RWA,142547046,55397214,-87149832
7146,2000,SAU,31854192246,75913176537,44058984291
7147,2000,SDN,1777576218,1986147524,208571306
7148,2000,SEN,1913913626,708103837,-1205809789
7149,2000,SGP,1.33E+11,1.36E+11,2916865847
7150,2000,SHN,42723034,11761861,-30961173
7151,2000,SLB,88834701,102143889,13309188
7152,2000,SLE,283132038,150488289,-132643749
7153,2000,SLV,4820136362,3080556527,-1739579835
7154,2000,SMR,68157391,37747003,-30410388
7155,2000,SOM,282666634,101819455,-180847179
7156,2000,SPM,47739411,9767762,-37971649
7157,2000,STP,41370409,20776691,-20593718
7158,2000,SUR,490973148,513501247,22528099
7159,2000,SVK,12283522814,11640113214,-643409600
7160,2000,SVN,10448904520,8633414629,-1815489891
7161,2000,SWE,72020776312,87668016192,15647239880
7162,2000,SWZ,1189470528,449833891,-739636637
7163,2000,SYC,345142920,178871533,-166271387
7164,2000,SYR,3959022790,4841991973,882969183
7165,2000,TCA,132145464,10024462,-122121002
7166,2000,TCD,123172194,93768519,-29403675
7167,2000,TGO,805427604,314270910,-491156694
7168,2000,THA,59973351712,73367054929,13393703217
7169,2000,TJK,560983318,518351285,-42632033
7170,2000,TKL,17923073,9663768,-8259305
7171,2000,TKM,1397728932,1505713124,107984192
7172,2000,TLS,60324915,33645948,-26678967
7173,2000,TON,62567403,18751186,-43816217
7174,2000,TTO,3136067217,4456825631,1320758414
7175,2000,TUN,8739293439,6149797609,-2589495830
7176,2000,TUR,51845760368,27160248043,-24685512325
7177,2000,TUV,7167352,1095881,-6071471
7178,2000,TWN,1.42E+11,1.80E+11,37118215968
7179,2000,TZA,1677860344,804346362,-873513982
7180,2000,UGA,915936821,454838098,-461098723
7181,2000,UKR,14982201703,15702160438,719958735
7182,2000,URY,4498087194,2697266966,-1800820228
7183,2000,USA,1.23E+12,7.98E+11,-4.34E+11
7184,2000,UZB,1953029191,2365879554,412850363
7185,2000,VAT,16207406,4202495,-12004911
7186,2000,VCT,280494955,122627662,-157867293
7187,2000,VEN,15164057231,32241381096,17077323865
7188,2000,VGB,4938732412,204308215,-4734424197
7189,2000,VNM,14534669707,15800573327,1265903620
7190,2000,VUT,105548383,98350709,-7197674
7191,2000,WLF,22768552,1338584,-21429968
7192,2000,WSM,178624632,56590852,-122033780
7193,2000,YEM,2247117369,3391090864,1143973495
7194,2000,ZAF,27132801197,36914684570,9781883373
7195,2000,ZMB,1067266868,677171802,-390095066
7196,2000,ZWE,1414606315,1830583037,415976722
7197,2001,ABW,609501553,1315334789,705833236
7198,2001,AGO,3218694076,6324991628,3106297552
7199,2001,AIA,42271357,7069038,-35202319
7200,2001,ALB,1320185391,344339814,-975845577
7201,2001,AND,947041651,74899714,-872141937
7202,2001,ANT,4513977693,1711598747,-2802378946
7203,2001,ARE,37313078141,35726756919,-1586321222
7204,2001,ARG,19669248208,27228599226,7559351018
7205,2001,ARM,682658691,277719014,-404939677
7206,2001,ASM,111949594,14396482,-97553112
7207,2001,ATA,7887213,627304,-7259909
7208,2001,ATG,403158126,205764874,-197393252
7209,2001,AUS,61261375869,61961203824,699827955
7210,2001,AUT,71061323192,64212990984,-6848332208
7211,2001,AZE,1675562812,1675972948,410136
7212,2001,BDI,112989483,35041001,-77948482
7213,2001,BEL,1.72E+11,1.87E+11,14850462409
7214,2001,BEN,1434916762,401309456,-1033607306
7215,2001,BFA,530052214,200546060,-329506154
7216,2001,BGD,8176148586,6452931832,-1723216754
7217,2001,BGR,7173046984,5060956977,-2112090007
7218,2001,BHR,2987727532,3147637744,159910212
7219,2001,BHS,3001123123,1124163427,-1876959696
7220,2001,BIH,2551946306,781640696,-1770305610
7221,2001,BLR,7702341243,7240057498,-462283745
7222,2001,BLZ,408938711,276384624,-132554087
7223,2001,BMU,3130087434,285344557,-2844742877
7224,2001,BOL,1576092950,1369892406,-206200544
7225,2001,BRA,58488021534,61424210037,2936188503
7226,2001,BRB,917847694,314399764,-603447930
7227,2001,BRN,1187639238,3429990536,2242351298
7228,2001,BTN,30125466,28990141,-1135325
7229,2001,BWA,1766212580,1778251584,12039004
7230,2001,CAF,83894149,165705505,81811356
7231,2001,CAN,2.35E+11,2.66E+11,30796441181
7232,2001,CCK,12240995,2117724,-10123271
7233,2001,CHE,91402860721,87223390106,-4179470615
7234,2001,CHL,16134745867,18672072040,2537326173
7235,2001,CHN,2.74E+11,4.01E+11,1.28E+11
7236,2001,CIV,2916209805,4290854033,1374644228
7237,2001,CMR,1993354594,2243696200,250341606
7238,2001,COD,591653795,1166624960,574971165
7239,2001,COG,893179923,2314892854,1421712931
7240,2001,COK,31015175,6903112,-24112063
7241,2001,COL,11520138487,13234464248,1714325761
7242,2001,COM,69618283,39039998,-30578285
7243,2001,CPV,269403968,15151540,-254252428
7244,2001,CRI,5723887723,6193740006,469852283
7245,2001,CUB,4304258948,1413356050,-2890902898
7246,2001,CXR,14443130,12362265,-2080865
7247,2001,CYM,1370575300,163408890,-1207166410
7248,2001,CYP,6106761590,1185552768,-4921208822
7249,2001,CZE,36305972913,33222749217,-3083223696
7250,2001,DEU,4.83E+11,5.56E+11,72616832031
7251,2001,DJI,461992659,62061266,-399931393
7252,2001,DMA,239283603,80362443,-158921160
7253,2001,DNK,41734655140,47060603255,5325948115
7254,2001,DOM,8379068984,4653926425,-3725142559
7255,2001,DZA,10578454586,17104578552,6526123966
7256,2001,ECU,5550767433,5823031918,272264485
7257,2001,EGY,18009053538,5913522052,-12095531486
7258,2001,ERI,196349093,11188954,-185160139
7259,2001,ESH,4032237,5374941,1342704
7260,2001,ESP,1.59E+11,1.14E+11,-44936455784
7261,2001,EST,5671179869,4629534895,-1041644974
7262,2001,ETH,1531057591,474396664,-1056660927
7263,2001,FIN,35985379411,43778065837,7792686426
7264,2001,FJI,678139158,466164883,-211974275
7265,2001,FLK,57968113,75844387,17876274
7266,2001,FRA,3.25E+11,2.91E+11,-34142522002
7267,2001,FRO,487487420,507193435,19706015
7268,2001,FSM,83992502,95790407,11797905
7269,2001,GAB,887322148,3049878290,2162556142
7270,2001,GBR,3.56E+11,2.80E+11,-76321078005
7271,2001,GEO,1007685494,639253117,-368432377
7272,2001,GHA,2826982700,1676816810,-1150165890
7273,2001,GIB,1502075174,102917307,-1399157867
7274,2001,GIN,728729080,907012847,178283767
7275,2001,GMB,354038931,29338838,-324700093
7276,2001,GNB,80668960,81080184,411224
7277,2001,GNQ,282251134,1748929928,1466678794
7278,2001,GRC,32650555180,11027348970,-21623206210
7279,2001,GRD,166179214,61146250,-105032964
7280,2001,GRL,354560287,388514562,33954275
7281,2001,GTM,5753425194,4637309471,-1116115723
7282,2001,GUM,538438355,60747996,-477690359
7283,2001,GUY,493769289,516268247,22498958
7284,2001,HKG,2.15E+11,1.90E+11,-24921759797
7285,2001,HND,4445918705,3936636711,-509281994
7286,2001,HRV,8429633469,4487472698,-3942160771
7287,2001,HTI,996510583,290424030,-706086553
7288,2001,HUN,33190559215,31356982322,-1833576893
7289,2001,IDN,35258608381,64532801343,29274192962
7290,2001,IND,39167496235,46270929884,7103433649
7291,2001,IOT,34004672,51162170,17157498
7292,2001,IRL,52211694148,87821720752,35610026604
7293,2001,IRN,17651990343,26941107710,9289117367
7294,2001,IRQ,5229822741,11227713188,5997890447
7295,2001,ISL,2338589716,2224359133,-114230583
7296,2001,ISR,30547244549,29228213847,-1319030702
7297,2001,ITA,2.19E+11,2.40E+11,20397207011
7298,2001,JAM,3223021605,1517847999,-1705173606
7299,2001,JOR,5060934609,2062942424,-2997992185
7300,2001,JPN,3.31E+11,4.36E+11,1.05E+11
7301,2001,KAZ,6023250892,10303156723,4279905831
7302,2001,KEN,4076557121,1973456214,-2103100907
7303,2001,KGZ,523427714,376831783,-146595931
7304,2001,KHM,2091507582,1715567518,-375940064
7305,2001,KIR,30069317,34483117,4413800
7306,2001,KNA,121872099,60413307,-61458792
7307,2001,KOR,1.36E+11,1.55E+11,19014712403
7308,2001,KWT,7587600252,15489280128,7901679876
7309,2001,LAO,645465913,324736295,-320729618
7310,2001,LBN,6934772314,1076134033,-5858638281
7311,2001,LBR,4162983268,1062301507,-3100681761
7312,2001,LBY,4166951459,11780230848,7613279389
7313,2001,LCA,476116444,68538642,-407577802
7314,2001,LKA,5440187625,4959494424,-480693201
7315,2001,LSO,698208778,233522337,-464686441
7316,2001,LTU,7095049209,5053823024,-2041226185
7317,2001,LUX,11495039080,7103454553,-4391584527
7318,2001,LVA,5206652993,2949303746,-2257349247
7319,2001,MAC,2620835350,2404106491,-216728859
7320,2001,MAR,11169404414,8125180589,-3044223825
7321,2001,MDA,1118509287,817259043,-301250244
7322,2001,MDG,1079208669,1049908457,-29300212
7323,2001,MDV,331602569,193610486,-137992083
7324,2001,MEX,1.52E+11,1.59E+11,7183471159
7325,2001,MHL,1047695677,150547636,-897148041
7326,2001,MKD,1901872014,954200266,-947671748
7327,2001,MLI,1017732049,407157039,-610575010
7328,2001,MLT,4353755042,2241649368,-2112105674
7329,2001,MMR,2407994831,2789738232,381743401
7330,2001,MNG,636759643,494693695,-142065948
7331,2001,MNP,203178730,11133810,-192044920
7332,2001,MOZ,1164155755,795390358,-368765397
7333,2001,MRT,601311288,528314130,-72997158
7334,2001,MSR,17192791,5213167,-11979624
7335,2001,MUS,2058741653,1690637745,-368103908
7336,2001,MWI,448754180,553233987,104479807
7337,2001,MYS,76458119096,1.07E+11,30981618067
7338,2001,MYT,167709646,2154803,-165554843
7339,2001,NAM,1799875537,1495675757,-304199780
7340,2001,NCL,838769967,472830820,-365939147
7341,2001,NER,486087483,225164518,-260922965
7342,2001,NGA,11029581302,19333106814,8303525512
7343,2001,NIC,1766564043,1045652536,-720911507
7344,2001,NIU,3447535,2764804,-682731
7345,2001,NLD,2.15E+11,2.02E+11,-12619885714
7346,2001,NOR,34179891790,58773676704,24593784914
7347,2001,NPL,680241340,724496090,44254750
7348,2001,NRU,23672789,17845550,-5827239
7349,2001,NZL,13137790456,14340259760,1202469304
7350,2001,OMN,6013090898,11063319986,5050229088
7351,2001,PAK,7260474630,8713148370,1452673740
7352,2001,PAN,14990658738,2837045896,-12153612842
7353,2001,PCN,10945057,1488996,-9456061
7354,2001,PER,6967990199,6591886531,-376103668
7355,2001,PHL,39930629499,41602788404,1672158905
7356,2001,PLW,53510143,28371738,-25138405
7357,2001,PNG,978236912,1535613136,557376224
7358,2001,POL,49777030190,34534982608,-15242047582
7359,2001,PRK,2933181267,925506589,-2007674678
7360,2001,PRT,41103397836,24227622400,-16875775436
7361,2001,PRY,2643280752,2050671652,-592609100
7362,2001,PSE,88930554,54528416,-34402138
7363,2001,PYF,856714309,153058160,-703656149
7364,2001,QAT,3554136526,11337606999,7783470473
7365,2001,ROU,15222606601,11792276547,-3430330054
7366,2001,RUS,53304433507,1.06E+11,52648419509
7367,2001,RWA,234399019,62642734,-171756285
7368,2001,SAU,33350872920,67956855980,34605983060
7369,2001,SDN,2089087928,1984853482,-104234446
7370,2001,SEN,1872471897,816991004,-1055480893
7371,2001,SGP,1.17E+11,1.24E+11,6871790102
7372,2001,SHN,33737619,10084700,-23652919
7373,2001,SLB,76727854,83146325,6418471
7374,2001,SLE,377668438,91466800,-286201638
7375,2001,SLV,4920537478,2991550698,-1928986780
7376,2001,SMR,119664375,30085378,-89578997
7377,2001,SOM,255070384,86131767,-168938617
7378,2001,SPM,47547069,13233024,-34314045
7379,2001,STP,53258408,12569986,-40688422
7380,2001,SUR,489717343,489663923,-53420
7381,2001,SVK,13486711513,12743497679,-743213834
7382,2001,SVN,10463994798,8988678447,-1475316351
7383,2001,SWE,64778907462,77640099862,12861192400
7384,2001,SWZ,834470018,365586789,-468883229
7385,2001,SYC,416125356,245944762,-170180594
7386,2001,SYR,4806775400,6983799510,2177024110
7387,2001,TCA,130177907,14390113,-115787794
7388,2001,TCD,316470083,79990634,-236479449
7389,2001,TGO,884034931,434719691,-449315240
7390,2001,THA,58122932365,70105892762,11982960397
7391,2001,TJK,326346522,340242555,13896033
7392,2001,TKL,35779373,16085113,-19694260
7393,2001,TKM,1108304449,2210739145,1102434696
7394,2001,TLS,79846325,7808364,-72037961
7395,2001,TON,54595585,24065275,-30530310
7396,2001,TTO,3472346822,5128644247,1656297425
7397,2001,TUN,9412832330,6754894915,-2657937415
7398,2001,TUR,38316780176,30129699879,-8187080297
7399,2001,TUV,404033897,287007748,-117026149
7400,2001,TWN,1.09E+11,1.58E+11,48668076324
7401,2001,TZA,1737062340,759048398,-978013942
7402,2001,UGA,835974287,483127080,-352847207
7403,2001,UKR,16635274776,17218653042,583378266
7404,2001,URY,3775483516,2359261643,-1416221873
7405,2001,USA,1.16E+12,7.31E+11,-4.25E+11
7406,2001,UZB,2116605592,2099337316,-17268276
7407,2001,VAT,19060012,2782504,-16277508
7408,2001,VCT,292999703,145879540,-147120163
7409,2001,VEN,17658379630,27483570237,9825190607
7410,2001,VGB,4068088156,227212246,-3840875910
7411,2001,VNM,15260431781,15858445060,598013279
7412,2001,VUT,144774921,63394884,-81380037
7413,2001,WLF,246666346,1458534,-245207812
7414,2001,WSM,194889435,60706590,-134182845
7415,2001,YEM,2510512739,2879126516,368613777
7416,2001,ZAF,26298812153,37129085668,10830273515
7417,2001,ZMB,1046243761,722420836,-323822925
7418,2001,ZWE,1410805723,1847222866,436417143
7419,2002,ABW,933993587,1002307020,68313433
7420,2002,AGO,2965974517,7535639078,4569664561
7421,2002,AIA,39969335,4205290,-35764045
7422,2002,ALB,1436191623,349790599,-1086401024
7423,2002,AND,1171938115,62343751,-1109594364
7424,2002,ANT,3788266492,1279830885,-2508435607
7425,2002,ARE,43639726619,36592840924,-7046885695
7426,2002,ARG,8381575374,26941519477,18559944103
7427,2002,ARM,961499048,422370999,-539128049
7428,2002,ASM,137436517,34594185,-102842332
7429,2002,ATA,7958044,300192,-7657852
7430,2002,ATG,464611947,244690651,-219921296
7431,2002,AUS,70354234255,63066192189,-7288042066
7432,2002,AUT,75382494233,70664521210,-4717973023
7433,2002,AZE,2122069568,1834588126,-287481442
7434,2002,BDI,123621737,35768813,-87852924
7435,2002,BEL,1.89E+11,2.12E+11,23258507720
7436,2002,BEN,1501171286,264825795,-1236345491
7437,2002,BFA,639386897,204646038,-434740859
7438,2002,BGD,7592207080,6439036563,-1153170517
7439,2002,BGR,7471736856,5868686879,-1603049977
7440,2002,BHR,3530935558,2863522089,-667413469
7441,2002,BHS,5129070646,1330538427,-3798532219
7442,2002,BIH,3035383570,873681480,-2161702090
7443,2002,BLR,8466428148,7349244008,-1117184140
7444,2002,BLZ,397051897,190604880,-206447017
7445,2002,BMU,4249804201,136864400,-4112939801
7446,2002,BOL,1643247863,1412524467,-230723396
7447,2002,BRA,50084836326,63599450252,13514613926
7448,2002,BRB,838242507,367176299,-471066208
7449,2002,BRN,1501137328,3534879099,2033741771
7450,2002,BTN,48413496,30136985,-18276511
7451,2002,BWA,3080918179,1610301843,-1470616336
7452,2002,CAF,93569150,179110717,85541567
7453,2002,CAN,2.33E+11,2.56E+11,23150907414
7454,2002,CCK,12792652,4930620,-7862032
7455,2002,CHE,90812210276,94617302854,3805092578
7456,2002,CHL,15069543329,18561485430,3491942101
7457,2002,CHN,3.21E+11,4.74E+11,1.53E+11
7458,2002,CIV,2810732850,5614531294,2803798444
7459,2002,CMR,1985295395,2031330804,46035409
7460,2002,COD,802932184,1384843038,581910854
7461,2002,COG,943999024,2111261356,1167262332
7462,2002,COK,38874058,8358644,-30515414
7463,2002,COL,11297500286,12864677834,1567177548
7464,2002,COM,84202135,30542942,-53659193
7465,2002,CPV,307394903,21300245,-286094658
7466,2002,CRI,6698458214,7490387375,791929161
7467,2002,CUB,3774220905,1327663478,-2446557427
7468,2002,CXR,36901918,31731171,-5170747
7469,2002,CYM,1157974806,217519189,-940455617
7470,2002,CYP,6824545938,1103446491,-5721099447
7471,2002,CZE,44949554845,43448059252,-1501495593
7472,2002,DEU,4.94E+11,6.00E+11,1.06E+11
7473,2002,DJI,538028559,71781211,-466247348
7474,2002,DMA,191018718,62032271,-128986447
7475,2002,DNK,45828862584,52139551433,6310688849
7476,2002,DOM,8398305739,4821687020,-3576618719
7477,2002,DZA,13104178947,16992216916,3888037969
7478,2002,ECU,6366039262,6080867202,-285172060
7479,2002,EGY,16410888932,7183425496,-9227463436
7480,2002,ERI,215144635,10029998,-205114637
7481,2002,ESH,1047229,7243028,6195799
7482,2002,ESP,1.72E+11,1.24E+11,-48096113267
7483,2002,EST,6829765229,4789970476,-2039794753
7484,2002,ETH,1432341802,464643894,-967697908
7485,2002,FIN,37048324915,43857799163,6809474248
7486,2002,FJI,782623726,481235218,-301388508
7487,2002,FLK,43938846,83906468,39967622
7488,2002,FRA,3.37E+11,3.06E+11,-30889376571
7489,2002,FRO,442166264,489148727,46982463
7490,2002,FSM,104789921,70065733,-34724188
7491,2002,GAB,870474070,2848368759,1977894689
7492,2002,GBR,3.67E+11,2.84E+11,-82647456777
7493,2002,GEO,986261013,658053697,-328207316
7494,2002,GHA,2723775103,1589134819,-1134640284
7495,2002,GIB,1657236830,103399504,-1553837326
7496,2002,GIN,913872113,905059570,-8812543
7497,2002,GMB,374063719,37148476,-336915243
7498,2002,GNB,82584329,84534118,1949789
7499,2002,GNQ,418102322,1829458759,1411356437
7500,2002,GRC,35318441759,11104755875,-24213685884
7501,2002,GRD,160531052,46263385,-114267667
7502,2002,GRL,380520646,423570989,43050343
7503,2002,GTM,6438558585,4812224461,-1626334124
7504,2002,GUM,479647155,55141475,-424505680
7505,2002,GUY,519076848,489417124,-29659724
7506,2002,HKG,2.28E+11,2.00E+11,-27665501194
7507,2002,HND,4616500106,4053724618,-562775488
7508,2002,HRV,10582617821,4748618370,-5833999451
7509,2002,HTI,1105719917,278417586,-827302331
7510,2002,HUN,39291181439,35088958202,-4202223237
7511,2002,IDN,37647790189,66431791093,28784000904
7512,2002,IND,44205764433,53042147598,8836383165
7513,2002,IOT,59319888,37834047,-21485841
7514,2002,IRL,56440910961,1.03E+11,46602344535
7515,2002,IRN,22034906673,25711471040,3676564367
7516,2002,IRQ,5861295689,9291151278,3429855589
7517,2002,ISL,1964764712,2294761258,329996546
7518,2002,ISR,30796350205,28864135430,-1932214775
7519,2002,ITA,2.33E+11,2.50E+11,16976229110
7520,2002,JAM,3430183137,1449727905,-1980455232
7521,2002,JOR,5561420293,2561438350,-2999981943
7522,2002,JPN,3.20E+11,4.43E+11,1.23E+11
7523,2002,KAZ,6776198424,12493656205,5717457781
7524,2002,KEN,3269690535,2075683401,-1194007134
7525,2002,KGZ,709355359,375501633,-333853726
7526,2002,KHM,2348861388,2148638678,-200222710
7527,2002,KIR,47794811,30180617,-17614194
7528,2002,KNA,139796411,67877848,-71918563
7529,2002,KOR,1.45E+11,1.67E+11,21738781897
7530,2002,KWT,8811793293,15168202155,6356408862
7531,2002,LAO,637526813,330169051,-307357762
7532,2002,LBN,6533322169,1270044845,-5263277324
7533,2002,LBR,4130789764,742641676,-3388148088
7534,2002,LBY,5273978048,10287993180,5014015132
7535,2002,LCA,495525619,70608370,-424917249
7536,2002,LKA,5899473176,4878092098,-1021381078
7537,2002,LSO,796831826,342561883,-454269943
7538,2002,LTU,8635237191,5915285693,-2719951498
7539,2002,LUX,12283615757,7962467988,-4321147769
7540,2002,LVA,5457384008,3094902343,-2362481665
7541,2002,MAC,2822337862,2488045317,-334292545
7542,2002,MAR,12362247560,8796105312,-3566142248
7543,2002,MDA,1223106874,798853010,-424253864
7544,2002,MDG,763992604,840222241,76229637
7545,2002,MDV,304521052,236325119,-68195933
7546,2002,MEX,1.56E+11,1.63E+11,6999198609
7547,2002,MHL,1499057669,212145812,-1286911857
7548,2002,MKD,1808037510,896345971,-911691539
7549,2002,MLI,956395321,550692163,-405703158
7550,2002,MLT,4683210387,2558756039,-2124454348
7551,2002,MMR,2584040774,2817591311,233550537
7552,2002,MNG,707734671,501483693,-206250978
7553,2002,MNP,343989877,9706247,-334283630
7554,2002,MOZ,1454618006,916071136,-538546870
7555,2002,MRT,747170727,557583927,-189586800
7556,2002,MSR,19058988,3495805,-15563183
7557,2002,MUS,2152110991,1785527903,-366583088
7558,2002,MWI,673391282,494837216,-178554066
7559,2002,MYS,81706368905,1.14E+11,31965664468
7560,2002,MYT,141856690,29136350,-112720340
7561,2002,NAM,1353373691,1359961337,6587646
7562,2002,NCL,1033856429,475739354,-558117075
7563,2002,NER,510562838,128368436,-382194402
7564,2002,NGA,12462089229,16550684643,4088595414
7565,2002,NIC,1796919172,1073054626,-723864546
7566,2002,NIU,4934651,4676989,-257662
7567,2002,NLD,2.22E+11,2.05E+11,-17287843174
7568,2002,NOR,36772260909,59960536072,23188275163
7569,2002,NPL,693556693,553613849,-139942844
7570,2002,NRU,262131473,14938298,-247193175
7571,2002,NZL,14695949631,14769697581,73747950
7572,2002,OMN,6871451522,10883612228,4012160706
7573,2002,PAK,8749481355,8975759486,226278131
7574,2002,PAN,14152782478,3016118544,-11136663934
7575,2002,PCN,9321326,2800831,-6520495
7576,2002,PER,7240471028,7369727960,129256932
7577,2002,PHL,39956467882,46048020327,6091552445
7578,2002,PLW,48020814,27448235,-20572579
7579,2002,PNG,1044154963,1470617561,426462598
7580,2002,POL,55380418529,39511106500,-15869312029
7581,2002,PRK,1780216461,938813444,-841403017
7582,2002,PRT,42469234948,26116409304,-16352825644
7583,2002,PRY,2147840977,2028104909,-119736068
7584,2002,PSE,83671770,75801134,-7870636
7585,2002,PYF,1071057144,172012249,-899044895
7586,2002,QAT,4219179780,11189856067,6970676287
7587,2002,ROU,17755004709,14517499636,-3237505073
7588,2002,RUS,58137659873,1.14E+11,55667226607
7589,2002,RWA,245338385,109390261,-135948124
7590,2002,SAU,35555930219,65847024429,30291094210
7591,2002,SDN,2722038599,2181617993,-540420606
7592,2002,SEN,2127124462,872978436,-1254146026
7593,2002,SGP,1.19E+11,1.29E+11,9729423754
7594,2002,SHN,37878572,22065260,-15813312
7595,2002,SLB,64504619,91300993,26796374
7596,2002,SLE,565297687,141817601,-423480086
7597,2002,SLV,4494429125,3023849205,-1470579920
7598,2002,SMR,120273650,28095674,-92177976
7599,2002,SOM,365008485,148201141,-216807344
7600,2002,SPM,36830908,5196706,-31634202
7601,2002,STP,61275775,12135235,-49140540
7602,2002,SUR,467322663,446393807,-20928856
7603,2002,SVK,16500208127,15914835927,-585372200
7604,2002,SVN,11315510333,10151737631,-1163772702
7605,2002,SWE,67546410892,82728635519,15182224627
7606,2002,SWZ,971757867,486116209,-485641658
7607,2002,SYC,346202953,371368381,25165428
7608,2002,SYR,7192530043,9325972462,2133442419
7609,2002,TCA,122602524,25065370,-97537154
7610,2002,TCD,402297305,64092794,-338204511
7611,2002,TGO,1000887131,389923563,-610963568
7612,2002,THA,61818287366,73488752765,11670465399
7613,2002,TJK,364536769,435612459,71075690
7614,2002,TKL,58346288,20871968,-37474320
7615,2002,TKM,1106126901,2584245972,1478119071
7616,2002,TLS,120222451,18581745,-101640706
7617,2002,TON,78849465,27891656,-50957809
7618,2002,TTO,3163034451,4633035436,1470000985
7619,2002,TUN,9641894951,7204624184,-2437270767
7620,2002,TUR,47271829505,35686185162,-11585644343
7621,2002,TUV,492700092,323774939,-168925153
7622,2002,TWN,1.16E+11,1.74E+11,57504035500
7623,2002,TZA,1872068784,849506649,-1022562135
7624,2002,UGA,1023321071,546061243,-477259828
7625,2002,UKR,18686571550,19182333418,495761868
7626,2002,URY,2396983420,2208737950,-188245470
7627,2002,USA,1.21E+12,6.97E+11,-5.08E+11
7628,2002,UZB,1921819168,1963407752,41588584
7629,2002,VAT,19054787,3359648,-15695139
7630,2002,VCT,283081962,176356327,-106725635
7631,2002,VEN,13285376363,26792579145,13507202782
7632,2002,VGB,3421357049,395258002,-3026099047
7633,2002,VNM,18728982803,18147629044,-581353759
7634,2002,VUT,107284063,59877084,-47406979
7635,2002,WLF,27073316,1014088,-26059228
7636,2002,WSM,143121465,37052342,-106069123
7637,2002,YEM,2940802443,2684762244,-256040199
7638,2002,ZAF,26505946962,38548135991,12042189029
7639,2002,ZMB,1126929624,860586534,-266343090
7640,2002,ZWE,1990646707,2584227882,593581175
7641,2003,ABW,1493658315,1199474883,-294183432
7642,2003,AGO,4424015027,8854408883,4430393856
7643,2003,AIA,47384186,9081931,-38302255
7644,2003,ALB,1781912614,453377484,-1328535130
7645,2003,AND,1462860757,85222365,-1377638392
7646,2003,ANT,6322769600,1442572426,-4880197174
7647,2003,ARE,54197863313,48918436583,-5279426730
7648,2003,ARG,13691916257,31097006345,17405090088
7649,2003,ARM,1182169926,651304274,-530865652
7650,2003,ASM,104173420,31510007,-72663413
7651,2003,ATA,8218900,1417279,-6801621
7652,2003,ATG,441970300,395567328,-46402972
7653,2003,AUS,83925833694,68144697189,-15781136505
7654,2003,AUT,90657440599,86232406886,-4425033713
7655,2003,AZE,3230993311,2051413717,-1179579594
7656,2003,BDI,160419637,38574508,-121845129
7657,2003,BEL,2.24E+11,2.50E+11,26316309130
7658,2003,BEN,1673005941,463875060,-1209130881
7659,2003,BFA,985876891,228939938,-756936953
7660,2003,BGD,9538517817,7692565168,-1845952649
7661,2003,BGR,10402966935,7391678049,-3011288886
7662,2003,BHR,4124448085,3229415348,-895032737
7663,2003,BHS,4940829686,1528116322,-3412713364
7664,2003,BIH,3652613537,1223476007,-2429137530
7665,2003,BLR,10929362031,8960474693,-1968887338
7666,2003,BLZ,455139841,273264966,-181874875
7667,2003,BMU,3757600836,360128127,-3397472709
7668,2003,BOL,1889161654,1694799222,-194362432
7669,2003,BRA,49408398321,78031821898,28623423577
7670,2003,BRB,973472851,376190271,-597282580
7671,2003,BRN,1674448101,4071567130,2397119029
7672,2003,BTN,121768616,58178097,-63590519
7673,2003,BWA,3694448585,2171437240,-1523011345
7674,2003,CAF,94056672,125555722,31499050
7675,2003,CAN,2.52E+11,2.73E+11,21152911538
7676,2003,CCK,12729853,1041395,-11688458
7677,2003,CHE,1.05E+11,1.09E+11,3128556923
7678,2003,CHL,17734450653,22760204023,5025753370
7679,2003,CHN,4.33E+11,5.98E+11,1.65E+11
7680,2003,CIV,2737094926,6339736896,3602641970
7681,2003,CMR,2297181732,2754722737,457541005
7682,2003,COD,892891976,1039139159,146247183
7683,2003,COG,1052225326,2588269272,1536043946
7684,2003,COK,57053637,10335673,-46717964
7685,2003,COL,12559793013,14213977901,1654184888
7686,2003,COM,109013947,35462211,-73551736
7687,2003,CPV,325812274,20602762,-305209512
7688,2003,CRI,7223353712,10196498086,2973144374
7689,2003,CUB,4182157626,1393564760,-2788592866
7690,2003,CXR,17642980,20913657,3270677
7691,2003,CYM,1514250102,618502584,-895747518
7692,2003,CYP,10637862868,1345947629,-9291915239
7693,2003,CZE,52895140186,49183703615,-3711436571
7694,2003,DEU,5.97E+11,7.37E+11,1.40E+11
7695,2003,DJI,637244330,68032494,-569211836
7696,2003,DMA,174661664,68452838,-106208826
7697,2003,DNK,53918009201,60501659030,6583649829
7698,2003,DOM,7282947750,5203701402,-2079246348
7699,2003,DZA,14745983489,22379848230,7633864741
7700,2003,ECU,6499237940,7372882272,873644332
7701,2003,EGY,17190949913,8636877099,-8554072814
7702,2003,ERI,440575819,8471244,-432104575
7703,2003,ESH,1525178,3810868,2285690
7704,2003,ESP,2.18E+11,1.54E+11,-64535556960
7705,2003,EST,7666753553,5972908111,-1693845442
7706,2003,ETH,2408452817,603270475,-1805182342
7707,2003,FIN,46267764972,51800970900,5533205928
7708,2003,FJI,914125294,552273613,-361851681
7709,2003,FLK,73159566,146892962,73733396
7710,2003,FRA,4.06E+11,3.57E+11,-48563894313
7711,2003,FRO,552716629,576803470,24086841
7712,2003,FSM,88515770,82409339,-6106431
7713,2003,GAB,991851710,3410242576,2418390866
7714,2003,GBR,4.10E+11,3.10E+11,-99576375180
7715,2003,GEO,1508775546,994130043,-514645503
7716,2003,GHA,3694312759,2125361074,-1568951685
7717,2003,GIB,1786893745,134896441,-1651997304
7718,2003,GIN,865516539,853932677,-11583862
7719,2003,GMB,480895761,30249650,-450646111
7720,2003,GNB,109679611,72179364,-37500247
7721,2003,GNQ,1077807685,2607950748,1530143063
7722,2003,GRC,45877378060,13447794461,-32429583599
7723,2003,GRD,195401201,49855222,-145545979
7724,2003,GRL,433420779,472738929,39318150
7725,2003,GTM,7086188707,5175526990,-1910661717
7726,2003,GUM,529925321,89207997,-440717324
7727,2003,GUY,591322649,525299638,-66023011
7728,2003,HKG,2.44E+11,2.21E+11,-23624777645
7729,2003,HND,5061290465,4192124078,-869166387
7730,2003,HRV,13603099292,5958440581,-7644658711
7731,2003,HTI,1195590084,361764743,-833825341
7732,2003,HUN,48931086342,43355522712,-5575563630
7733,2003,IDN,54479401341,75725927445,21246526104
7734,2003,IND,55035156774,65757039738,10721882964
7735,2003,IOT,7482298,3951797,-3530501
7736,2003,IRL,58559258588,1.07E+11,48438369923
7737,2003,IRN,28078610138,33884996738,5806386600
7738,2003,IRQ,5186720118,8623966032,3437245914
7739,2003,ISL,2528550710,2480786918,-47763792
7740,2003,ISR,31550181290,30471327159,-1078854131
7741,2003,ITA,2.82E+11,2.94E+11,12106462789
7742,2003,JAM,3589303870,1561358707,-2027945163
7743,2003,JOR,6781241400,2972144586,-3809096814
7744,2003,JPN,3.64E+11,5.00E+11,1.36E+11
7745,2003,KAZ,9215098390,14580914061,5365815671
7746,2003,KEN,3920862440,2665098655,-1255763785
7747,2003,KGZ,957563999,458631428,-498932571
7748,2003,KHM,2688353652,2650008038,-38345614
7749,2003,KIR,37295031,25483563,-11811468
7750,2003,KNA,188210270,63331037,-124879233
7751,2003,KOR,1.70E+11,1.99E+11,29231844082
7752,2003,KWT,11133868212,19621631700,8487763488
7753,2003,LAO,718924527,358913267,-360011260
7754,2003,LBN,7733178450,1524906980,-6208271470
7755,2003,LBR,3868446247,965503686,-2902942561
7756,2003,LBY,5796575363,14315405174,8518829811
7757,2003,LCA,287416680,60333731,-227082949
7758,2003,LKA,6674011362,5237919849,-1436091513
7759,2003,LSO,1143669691,415547302,-728122389
7760,2003,LTU,11106747725,7875273254,-3231474471
7761,2003,LUX,14858985749,10795152987,-4063832762
7762,2003,LVA,6708561081,3798005906,-2910555175
7763,2003,MAC,3308800407,2759938908,-548861499
7764,2003,MAR,14811996316,9960790765,-4851205551
7765,2003,MDA,1687622920,1028246333,-659376587
7766,2003,MDG,1436656504,1149371619,-287284885
7767,2003,MDV,391555565,201053613,-190501952
7768,2003,MEX,1.58E+11,1.70E+11,11446140544
7769,2003,MHL,1785827447,179619889,-1606207558
7770,2003,MKD,2087392755,1154116883,-933275872
7771,2003,MLI,1233146542,376860769,-856285773
7772,2003,MLT,5043472699,3101308646,-1942164053
7773,2003,MMR,2903000137,2756041609,-146958528
7774,2003,MNG,832509876,596259759,-236250117
7775,2003,MNP,354108722,12304775,-341803947
7776,2003,MOZ,1429330969,1028815856,-400515113
7777,2003,MRT,827713367,576316127,-251397240
7778,2003,MSR,28672841,9309859,-19362982
7779,2003,MUS,2395520166,1856648561,-538871605
7780,2003,MWI,595419212,627083767,31664555
7781,2003,MYS,87657512562,1.30E+11,42644156233
7782,2003,MYT,173157048,4947207,-168209841
7783,2003,NAM,1486837172,1607324808,120487636
7784,2003,NCL,1322961297,632028416,-690932881
7785,2003,NER,600007200,203238151,-396769049
7786,2003,NGA,14287936928,24015280750,9727343822
7787,2003,NIC,1953461027,1172238438,-781222589
7788,2003,NIU,4291889,2736840,-1555049
7789,2003,NLD,2.61E+11,2.52E+11,-8835771746
7790,2003,NOR,42978795959,70711414055,27732618096
7791,2003,NPL,1275484505,646032813,-629451692
7792,2003,NRU,25433180,31149890,5716710
7793,2003,NZL,18106260916,16879653667,-1226607249
7794,2003,OMN,4516380910,11030181111,6513800201
7795,2003,PAK,14415495280,11944254729,-2471240551
7796,2003,PAN,16209217374,2870893068,-13338324306
7797,2003,PCN,6071059,2994947,-3076112
7798,2003,PER,8273224556,8378097973,104873417
7799,2003,PHL,44117721419,49812712157,5694990738
7800,2003,PLW,36065455,16068880,-19996575
7801,2003,PNG,1206892700,2136583850,929691150
7802,2003,POL,67828293756,52783473606,-15044820150
7803,2003,PRK,1606127510,936622359,-669505151
7804,2003,PRT,49093778641,31719120024,-17374658617
7805,2003,PRY,2574858924,2104353757,-470505167
7806,2003,PSE,97247342,84602498,-12644844
7807,2003,PYF,1369419768,181466422,-1187953346
7808,2003,QAT,5727700216,13529456441,7801756225
7809,2003,ROU,23918314954,18290036580,-5628278374
7810,2003,RUS,76080872258,1.42E+11,65798675464
7811,2003,RWA,296367077,106802665,-189564412
7812,2003,SAU,39389812202,86300231707,46910419505
7813,2003,SDN,3176963010,2697136052,-479826958
7814,2003,SEN,2589603077,1043676541,-1545926536
7815,2003,SGP,1.31E+11,1.57E+11,25386294195
7816,2003,SHN,31874362,18940993,-12933369
7817,2003,SLB,104676249,123325465,18649216
7818,2003,SLE,536971456,196001620,-340969836
7819,2003,SLV,4991028106,3152437336,-1838590770
7820,2003,SMR,141656047,40579534,-101076513
7821,2003,SOM,275584176,186378537,-89205639
7822,2003,SPM,46528547,4537859,-41990688
7823,2003,STP,62234838,12418961,-49815877
7824,2003,SUR,633863904,538982304,-94881600
7825,2003,SVK,21966415164,22421180762,454765598
7826,2003,SVN,14007102512,12398866581,-1608235931
7827,2003,SWE,82793526639,1.02E+11,18924969118
7828,2003,SWZ,1404378247,573811473,-830566774
7829,2003,SYC,370819816,376929694,6109878
7830,2003,SYR,6995839996,6385504151,-610335845
7831,2003,TCA,147991700,32312957,-115678743
7832,2003,TCD,313670721,93501533,-220169188
7833,2003,TGO,1334349066,914239251,-420109815
7834,2003,THA,71281446211,87073191482,15791745271
7835,2003,TJK,630420508,545704152,-84716356
7836,2003,TKL,82012528,33177844,-48834684
7837,2003,TKM,1514242041,2612423226,1098181185
7838,2003,TLS,135677369,6178464,-129498905
7839,2003,TON,78973233,30643173,-48330060
7840,2003,TTO,3811092191,6993686864,3182594673
7841,2003,TUN,10882479886,8455267360,-2427212526
7842,2003,TUR,64733647242,46610361812,-18123285430
7843,2003,TUV,17305010,2641697,-14663313
7844,2003,TWN,1.32E+11,1.80E+11,47398412365
7845,2003,TZA,2471307942,1133540424,-1337767518
7846,2003,UGA,1297283250,644731285,-652551965
7847,2003,UKR,25081464093,24711440183,-370023910
7848,2003,URY,2818327767,2606831758,-211496009
7849,2003,USA,1.31E+12,7.30E+11,-5.77E+11
7850,2003,UZB,2279409702,2343244191,63834489
7851,2003,VAT,22606937,6582364,-16024573
7852,2003,VCT,321096401,85809887,-235286514
7853,2003,VEN,8765863111,29447824556,20681961445
7854,2003,VGB,3927003519,391681115,-3535322404
7855,2003,VNM,24031674515,22492672574,-1539001941
7856,2003,VUT,173514824,74562516,-98952308
7857,2003,WLF,35618967,1041053,-34577914
7858,2003,WSM,162405989,22646550,-139759439
7859,2003,YEM,3003222986,3651958050,648735064
7860,2003,ZAF,33746458130,45313500060,11567041930
7861,2003,ZMB,1213519057,925980869,-287538188
7862,2003,ZWE,1413523620,1839735917,426212297
7863,2004,ABW,2438943957,2390181740,-48762217
7864,2004,AGO,6655861038,12133820184,5477959146
7865,2004,AIA,55187774,5376392,-49811382
7866,2004,ALB,2181433367,547190939,-1634242428
7867,2004,AND,1694442825,116038127,-1578404698
7868,2004,ANT,3027048884,1724959024,-1302089860
7869,2004,ARE,67871069215,69038082207,1167012992
7870,2004,ARG,21674446117,36820379448,15145933331
7871,2004,ARM,1321249962,580784370,-740465592
7872,2004,ASM,119278074,21497436,-97780638
7873,2004,ATA,11470094,2436351,-9033743
7874,2004,ATG,600831987,175026444,-425805543
7875,2004,AUS,1.05E+11,85645784549,-19317349161
7876,2004,AUT,1.12E+11,1.06E+11,-5295056140
7877,2004,AZE,4436341251,2901245981,-1535095270
7878,2004,BDI,212914020,31844619,-181069401
7879,2004,BEL,2.76E+11,3.02E+11,26506775729
7880,2004,BEN,1813576946,541164947,-1272411999
7881,2004,BFA,1061920931,378911139,-683009792
7882,2004,BGD,11896438487,9692419702,-2204018785
7883,2004,BGR,14106823878,9695579310,-4411244568
7884,2004,BHR,4547940271,3959378578,-588561693
7885,2004,BHS,4822403505,1711858678,-3110544827
7886,2004,BIH,4507004709,1745166482,-2761838227
7887,2004,BLR,15568512458,12280201026,-3288311432
7888,2004,BLZ,495726611,293470072,-202256539
7889,2004,BMU,1732120672,181675206,-1550445466
7890,2004,BOL,2221829132,2174574036,-47255096
7891,2004,BRA,66158060864,1.04E+11,37973502942
7892,2004,BRB,998193543,513155187,-485038356
7893,2004,BRN,1488816839,4667642100,3178825261
7894,2004,BTN,244055489,57499345,-186556144
7895,2004,BWA,3111460930,3218685410,107224480
7896,2004,CAF,125886419,130651251,4764832
7897,2004,CAN,2.87E+11,3.19E+11,32491811904
7898,2004,CCK,15842226,5758831,-10083395
7899,2004,CHE,1.24E+11,1.30E+11,5384298402
7900,2004,CHL,23086792116,34391483670,11304691554
7901,2004,CHN,5.71E+11,7.73E+11,2.01E+11
7902,2004,CIV,3482507773,7172130168,3689622395
7903,2004,CMR,2415893918,3283745689,867851771
7904,2004,COD,1240659239,1172000538,-68658701
7905,2004,COG,1169883052,4046417858,2876534806
7906,2004,COK,75709936,16182858,-59527078
7907,2004,COL,15613896194,18318772715,2704876521
7908,2004,COM,100914561,36335108,-64579453
7909,2004,CPV,423741724,22282705,-401459019
7910,2004,CRI,7787658647,11569434692,3781776045
7911,2004,CUB,5077717517,2535516400,-2542201117
7912,2004,CXR,24124657,14898523,-9226134
7913,2004,CYM,1810642752,644659838,-1165982914
7914,2004,CYP,14182713984,1793003503,-12389710481
7915,2004,CZE,65714960186,63736972150,-1977988036
7916,2004,DEU,7.31E+11,8.97E+11,1.66E+11
7917,2004,DJI,707658367,32339748,-675318619
7918,2004,DMA,200012058,72414881,-127597177
7919,2004,DNK,64549271161,70065701527,5516430366
7920,2004,DOM,7867240370,5617201295,-2250039075
7921,2004,DZA,19295351569,29225958046,9930606477
7922,2004,ECU,7949625979,10552751873,2603125894
7923,2004,EGY,22259440278,11573311973,-10686128305
7924,2004,ERI,374596749,11134138,-363462611
7925,2004,ESH,2043009,1812933,-230076
7926,2004,ESP,2.70E+11,1.80E+11,-90101837552
7927,2004,EST,9950248643,7579031175,-2371217468
7928,2004,ETH,2691667028,673664563,-2018002465
7929,2004,FIN,57609242821,61773032050,4163789229
7930,2004,FJI,1265949125,619212250,-646736875
7931,2004,FLK,82323165,129380894,47057729
7932,2004,FRA,4.82E+11,4.14E+11,-68091665387
7933,2004,FRO,584446402,613723432,29277030
7934,2004,FSM,101958057,69902886,-32055171
7935,2004,GAB,1197601409,4208446808,3010845399
7936,2004,GBR,4.86E+11,3.52E+11,-1.34E+11
7937,2004,GEO,2184492990,1266001593,-918491397
7938,2004,GHA,4178758929,2250592863,-1928166066
7939,2004,GIB,2775245420,162548119,-2612697301
7940,2004,GIN,1181383679,969900842,-211482837
7941,2004,GMB,529666723,39603650,-490063073
7942,2004,GNB,113891738,107832398,-6059340
7943,2004,GNQ,701873008,4079398288,3377525280
7944,2004,GRC,55119393733,15122858128,-39996535605
7945,2004,GRD,247139416,29135279,-218004137
7946,2004,GRL,529362425,513422364,-15940061
7947,2004,GTM,8338060489,5693854725,-2644205764
7948,2004,GUM,678382735,65318456,-613064279
7949,2004,GUY,581288481,611588951,30300470
7950,2004,HKG,2.79E+11,2.55E+11,-23770085258
7951,2004,HND,5818228907,4688856132,-1129372775
7952,2004,HRV,16586239970,7479613635,-9106626335
7953,2004,HTI,1191876429,427581312,-764295117
7954,2004,HUN,55624361050,54650900645,-973460405
7955,2004,IDN,69063741888,89087486973,20023745085
7956,2004,IND,74770449251,85109662933,10339213682
7957,2004,IOT,10752566,3245649,-7506917
7958,2004,IRL,70964244376,1.24E+11,53008963449
7959,2004,IRN,37836146820,43234993406,5398846586
7960,2004,IRQ,9814116374,16606499348,6792382974
7961,2004,ISL,3511561463,2808307426,-703254037
7962,2004,ISR,39561440342,37002565107,-2558875235
7963,2004,ITA,3.37E+11,3.47E+11,10299795758
7964,2004,JAM,3655436031,1697358475,-1958077556
7965,2004,JOR,9614663991,4057811999,-5556851992
7966,2004,JPN,4.27E+11,5.99E+11,1.72E+11
7967,2004,KAZ,14359516137,19515516578,5156000441
7968,2004,KEN,5096375230,3072576974,-2023798256
7969,2004,KGZ,1446474739,494200259,-952274480
7970,2004,KHM,3237492299,2876017841,-361474458
7971,2004,KIR,49058432,10949389,-38109043
7972,2004,KNA,307861683,63644728,-244216955
7973,2004,KOR,2.13E+11,2.60E+11,46720132924
7974,2004,KWT,12916363220,26435753255,13519390035
7975,2004,LAO,968810571,427751466,-541059105
7976,2004,LBN,9274590200,2145181241,-7129408959
7977,2004,LBR,4439586269,790137969,-3649448300
7978,2004,LBY,7426520332,19925175762,12498655430
7979,2004,LCA,331653583,84205997,-247447586
7980,2004,LKA,8146303239,6130285715,-2016017524
7981,2004,LSO,1385720951,513189951,-872531000
7982,2004,LTU,12919574064,9385159925,-3534414139
7983,2004,LUX,19328148462,14101111719,-5227036743
7984,2004,LVA,8015288257,5535198921,-2480089336
7985,2004,MAC,3713493304,3238377342,-475115962
7986,2004,MAR,18764774959,11776708036,-6988066923
7987,2004,MDA,2284333377,1386254838,-898078539
7988,2004,MDG,1624869489,1323816444,-301053045
7989,2004,MDV,531246433,203596486,-327649947
7990,2004,MEX,1.90E+11,1.94E+11,3492315141
7991,2004,MHL,1552906077,158203846,-1394702231
7992,2004,MKD,2630611993,1463449968,-1167162025
7993,2004,MLI,1377908316,517902060,-860006256
7994,2004,MLT,5745946315,3444705928,-2301240387
7995,2004,MMR,3287328331,3718403064,431074733
7996,2004,MNG,1055063411,843721852,-211341559
7997,2004,MNP,363279508,18485559,-344793949
7998,2004,MOZ,1709614452,1558586133,-151028319
7999,2004,MRT,952493238,790068192,-162425046
8000,2004,MSR,19788448,4284925,-15503523
8001,2004,MUS,2809692228,1978471090,-831221138
8002,2004,MWI,809808644,579726340,-230082304
8003,2004,MYS,1.10E+11,1.54E+11,44339984071
8004,2004,MYT,221743451,4762561,-216980890
8005,2004,NAM,2511593716,2368781953,-142811763
8006,2004,NCL,1473871551,952425485,-521446066
8007,2004,NER,694647314,286287620,-408359694
8008,2004,NGA,15260084629,33188613395,17928528766
8009,2004,NIC,2386526594,1464235527,-922291067
8010,2004,NIU,12107813,1786158,-10321655
8011,2004,NLD,3.22E+11,3.13E+11,-8550647005
8012,2004,NOR,52053620364,85314516495,33260896131
8013,2004,NPL,1255122773,665810661,-589312112
8014,2004,NRU,17858717,16990107,-868610
8015,2004,NZL,22440981806,20331346030,-2109635776
8016,2004,OMN,8511504648,13504596776,4993092128
8017,2004,PAK,18914792800,12792714872,-6122077928
8018,2004,PAN,19665987094,3311340978,-16354646116
8019,2004,PCN,11719748,19223445,7503697
8020,2004,PER,10142885309,11936351881,1793466572
8021,2004,PHL,49738125894,56930096559,7191970665
8022,2004,PLW,46888126,21912482,-24975644
8023,2004,PNG,1446376975,2317198871,870821896
8024,2004,POL,85642836869,71842232320,-13800604549
8025,2004,PRK,2251856832,1252255184,-999601648
8026,2004,PRT,59242683655,37017149935,-22225533720
8027,2004,PRY,3415195398,3109698920,-305496478
8028,2004,PSE,135856368,31939436,-103916932
8029,2004,PYF,1314383478,212927107,-1101456371
8030,2004,QAT,7436053656,18120760169,10684706513
8031,2004,ROU,32928436391,24009491922,-8918944469
8032,2004,RUS,1.03E+11,2.04E+11,1.01E+11
8033,2004,RWA,351634714,406240839,54606125
8034,2004,SAU,44250292725,1.15E+11,70275265370
8035,2004,SDN,4523414066,4665547085,142133019
8036,2004,SEN,2986418114,1161302431,-1825115683
8037,2004,SGP,1.65E+11,1.94E+11,29200978133
8038,2004,SHN,39121711,15563132,-23558579
8039,2004,SLB,116923510,184713638,67790128
8040,2004,SLE,465234095,225922477,-239311618
8041,2004,SLV,5381491979,3283823857,-2097668122
8042,2004,SMR,168105900,43698161,-124407739
8043,2004,SOM,386025306,199607787,-186417519
8044,2004,SPM,66122011,7405194,-58716817
8045,2004,STP,67407901,12360587,-55047314
8046,2004,SUR,680265423,781494986,101229563
8047,2004,SVK,26346583148,28238918071,1892334923
8048,2004,SVN,17563012521,14907035620,-2655976901
8049,2004,SWE,1.01E+11,1.23E+11,22118862560
8050,2004,SWZ,1758432871,771810408,-986622463
8051,2004,SYC,498772816,392723236,-106049580
8052,2004,SYR,13194920586,8630685689,-4564234897
8053,2004,TCA,200803594,29263030,-171540564
8054,2004,TCD,332474604,1199051869,866577265
8055,2004,TGO,1628965548,657239699,-971725849
8056,2004,THA,90564445938,1.06E+11,15021697933
8057,2004,TJK,818477159,610730908,-207746251
8058,2004,TKL,74987518,19980078,-55007440
8059,2004,TKM,2153908293,3412087176,1258178883
8060,2004,TLS,102250212,50008123,-52242089
8061,2004,TON,87791488,27288793,-60502695
8062,2004,TTO,4791126154,8602955465,3811829311
8063,2004,TUN,13016651028,9916151681,-3100499347
8064,2004,TUR,94544990225,61991576118,-32553414107
8065,2004,TUV,16549832,1893985,-14655847
8066,2004,TWN,1.76E+11,2.26E+11,49909231692
8067,2004,TZA,2987628466,1505728476,-1481899990
8068,2004,UGA,1668043456,784844546,-883198910
8069,2004,UKR,32226367167,34855491849,2629124682
8070,2004,URY,4238253510,3310803640,-927449870
8071,2004,USA,1.53E+12,8.36E+11,-6.91E+11
8072,2004,UZB,2880168241,3254839915,374671674
8073,2004,VAT,24875514,3025122,-21850392
8074,2004,VCT,429263226,243531536,-185731690
8075,2004,VEN,16042556883,37909444821,21866887938
8076,2004,VGB,4260455745,434003552,-3826452193
8077,2004,VNM,30860859254,28904984378,-1955874876
8078,2004,VUT,185682006,218327858,32645852
8079,2004,WLF,34094351,1420143,-32674208
8080,2004,WSM,194672753,16937968,-177734785
8081,2004,YEM,4691119573,4166429359,-524690214
8082,2004,ZAF,48017406348,57697937395,9680531047
8083,2004,ZMB,1585662646,1715253228,129590582
8084,2004,ZWE,1915814592,2270814763,355000171
8085,2005,ABW,2938720678,3817356941,878636263
8086,2005,AGO,7730523144,20981437322,13250914178
8087,2005,AIA,87123072,12983746,-74139326
8088,2005,ALB,2530919897,614429895,-1916490002
8089,2005,AND,1744070866,156872649,-1587198217
8090,2005,ANT,4536322721,3083767130,-1452555591
8091,2005,ARE,91280414763,97945233043,6664818280
8092,2005,ARG,27190592081,41848453958,14657861877
8093,2005,ARM,1685547390,873217054,-812330336
8094,2005,ASM,113954836,16787167,-97167669
8095,2005,ATA,22404319,2072703,-20331616
8096,2005,ATG,976142466,291193104,-684949362
8097,2005,AUS,1.19E+11,1.04E+11,-14089371258
8098,2005,AUT,1.21E+11,1.13E+11,-7605664126
8099,2005,AZE,5259002957,4827303597,-431699360
8100,2005,BDI,262472844,81297252,-181175592
8101,2005,BEL,3.07E+11,3.29E+11,22231726570
8102,2005,BEN,2533330368,639077519,-1894252849
8103,2005,BFA,1123618287,298991773,-824626514
8104,2005,BGD,13251971994,10173230982,-3078741012
8105,2005,BGR,16463865572,11501166849,-4962698723
8106,2005,BHR,6436437113,5298422015,-1138015098
8107,2005,BHS,8240777234,2455109545,-5785667689
8108,2005,BIH,5341474628,2640293000,-2701181628
8109,2005,BLR,15702714593,16741822938,1039108345
8110,2005,BLZ,656888697,330518009,-326370688
8111,2005,BMU,2036852848,477465666,-1559387182
8112,2005,BOL,2817454565,2793740623,-23713942
8113,2005,BRA,76373707882,1.26E+11,49422485214
8114,2005,BRB,1314490127,401953427,-912536700
8115,2005,BRN,1486016679,5870124120,4384107441
8116,2005,BTN,160109152,127851869,-32257283
8117,2005,BWA,3169365831,4017438823,848072992
8118,2005,CAF,151907435,117953520,-33953915
8119,2005,CAN,3.36E+11,3.58E+11,22160206804
8120,2005,CCK,8857484,2382108,-6475376
8121,2005,CHE,1.49E+11,1.40E+11,-8457361135
8122,2005,CHL,30641825867,42628109684,11986283817
8123,2005,CHN,6.64E+11,9.67E+11,3.03E+11
8124,2005,CIV,4549583071,7846253591,3296670520
8125,2005,CMR,2967707903,3587792265,620084362
8126,2005,COD,1612204491,1433004214,-179200277
8127,2005,COG,1565609198,5992718744,4427109546
8128,2005,COK,81890554,18952929,-62937625
8129,2005,COL,19947554181,23059743294,3112189113
8130,2005,COM,117226851,28569472,-88657379
8131,2005,CPV,509740361,28623550,-481116811
8132,2005,CRI,8856057102,12443843316,3587786214
8133,2005,CUB,7268886259,2420383945,-4848502314
8134,2005,CXR,46530011,17603356,-28926655
8135,2005,CYM,2121770804,758109632,-1363661172
8136,2005,CYP,14993870298,2474131934,-12519738364
8137,2005,CZE,74674072270,73131240910,-1542831360
8138,2005,DEU,7.93E+11,9.62E+11,1.69E+11
8139,2005,DJI,1011439926,94644439,-916795487
8140,2005,DMA,243083351,84712121,-158371230
8141,2005,DNK,71832553360,74358171066,2525617706
8142,2005,DOM,9286656514,5783164695,-3503491819
8143,2005,DZA,22072227368,40186553990,18114326622
8144,2005,ECU,9341766567,12576135959,3234369392
8145,2005,EGY,27809893851,14216566518,-13593327333
8146,2005,ERI,327496020,26058437,-301437583
8147,2005,ESH,1724682,1872700,148018
8148,2005,ESP,3.04E+11,1.88E+11,-1.16E+11
8149,2005,EST,12148112521,8952893321,-3195219200
8150,2005,ETH,3621959209,989685432,-2632273777
8151,2005,FIN,66167044579,69997172457,3830127878
8152,2005,FJI,1376347457,773563338,-602784119
8153,2005,FLK,60240151,159891268,99651117
8154,2005,FRA,5.25E+11,4.34E+11,-91216159619
8155,2005,FRO,712685782,550656035,-162029747
8156,2005,FSM,88891629,50139818,-38751811
8157,2005,GAB,1476649289,5071207224,3594557935
8158,2005,GBR,5.10E+11,3.92E+11,-1.17E+11
8159,2005,GEO,2722293000,1452094656,-1270198344
8160,2005,GHA,5270643293,2769478869,-2501164424
8161,2005,GIB,3583840076,215570768,-3368269308
8162,2005,GIN,1433548343,1245546918,-188001425
8163,2005,GMB,590988251,32012939,-558975312
8164,2005,GNB,185652424,98340253,-87312171
8165,2005,GNQ,1018634022,6292852539,5274218517
8166,2005,GRC,57191215351,17404818450,-39786396901
8167,2005,GRD,296738123,34929515,-261808608
8168,2005,GRL,645590394,550490436,-95099958
8169,2005,GTM,9314654120,6201131759,-3113522361
8170,2005,GUM,920591670,70406200,-850185470
8171,2005,GUY,727035656,588021937,-139013719
8172,2005,HKG,3.09E+11,2.83E+11,-26495564852
8173,2005,HND,6608751130,5007805926,-1600945204
8174,2005,HRV,18408515360,8643796648,-9764718712
8175,2005,HTI,1399478773,521442937,-878035836
8176,2005,HUN,62958953703,60605576154,-2353377549
8177,2005,IDN,80041128938,98439968071,18398839133
8178,2005,IND,1.02E+11,1.06E+11,4123353455
8179,2005,IOT,10088642,3701019,-6387623
8180,2005,IRL,80101992041,1.33E+11,52497547156
8181,2005,IRN,41774029944,65308824077,23534794133
8182,2005,IRQ,12021663439,17918012116,5896348677
8183,2005,ISL,4584428334,2783926543,-1800501791
8184,2005,ISR,43156381768,42021949503,-1134432265
8185,2005,ITA,3.67E+11,3.67E+11,-97191943
8186,2005,JAM,4444988958,1872107856,-2572881102
8187,2005,JOR,11140001261,4455725521,-6684275740
8188,2005,JPN,4.94E+11,6.37E+11,1.43E+11
8189,2005,KAZ,19471551559,30917766446,11446214887
8190,2005,KEN,6323039473,3627567787,-2695471686
8191,2005,KGZ,2001435220,672194389,-1329240831
8192,2005,KHM,3876136641,3114565459,-761571182
8193,2005,KIR,59431428,6470199,-52961229
8194,2005,KNA,204680111,68275568,-136404543
8195,2005,KOR,2.47E+11,2.88E+11,41437188315
8196,2005,KWT,14131780461,36903495349,22771714888
8197,2005,LAO,1119886923,590985912,-528901011
8198,2005,LBN,8853405837,2097470910,-6755934927
8199,2005,LBR,5216500635,1421293097,-3795207538
8200,2005,LBY,8094145870,29469983190,21375837320
8201,2005,LCA,649827256,156461230,-493366026
8202,2005,LKA,9459956260,6699592118,-2760364142
8203,2005,LSO,236474901,489214098,252739197
8204,2005,LTU,14809825091,12055210490,-2754614601
8205,2005,LUX,21777829170,15333846761,-6443982409
8206,2005,LVA,9729408902,6809912718,-2919496184
8207,2005,MAC,4062009422,2588279774,-1473729648
8208,2005,MAR,21093237086,12839074536,-8254162550
8209,2005,MDA,2819607970,1440326204,-1379281766
8210,2005,MDG,1586002755,1109798065,-476204690
8211,2005,MDV,602858595,144692562,-458166033
8212,2005,MEX,2.08E+11,2.17E+11,8574862102
8213,2005,MHL,2718012956,569523377,-2148489579
8214,2005,MKD,2860427286,1944205904,-916221382
8215,2005,MLI,1652297692,408756011,-1243541681
8216,2005,MLT,5592204516,3174404378,-2417800138
8217,2005,MMR,3198662136,3746755587,548093451
8218,2005,MNG,1215381785,883767118,-331614667
8219,2005,MNP,342590437,12549743,-330040694
8220,2005,MOZ,2225621528,2023877969,-201743559
8221,2005,MRT,1132181687,940731213,-191450474
8222,2005,MSR,17119623,4176459,-12943164
8223,2005,MUS,3349526975,2081670895,-1267856080
8224,2005,MWI,889924056,720775872,-169148184
8225,2005,MYS,1.19E+11,1.67E+11,48765809739
8226,2005,MYT,265058087,4069799,-260988288
8227,2005,NAM,2669017714,2718815697,49797983
8228,2005,NCL,1610451962,1025561521,-584890441
8229,2005,NER,821871731,243658265,-578213466
8230,2005,NGA,18291612627,44545641937,26254029310
8231,2005,NIC,2811704832,1869944404,-941760428
8232,2005,NIU,15064461,1634095,-13430366
8233,2005,NLD,3.68E+11,3.47E+11,-20274351832
8234,2005,NOR,58568667352,1.07E+11,48059972672
8235,2005,NPL,1329373076,670591574,-658781502
8236,2005,NRU,25561003,4207056,-21353947
8237,2005,NZL,25621678135,21843309912,-3778368223
8238,2005,OMN,8925139103,18442654782,9517515679
8239,2005,PAK,26014747400,14948360314,-11066387086
8240,2005,PAN,23480267674,4497544828,-18982722846
8241,2005,PCN,4108847,4209429,100582
8242,2005,PER,12319334696,16164693497,3845358801
8243,2005,PHL,52047462573,62200113774,10152651201
8244,2005,PLW,38868529,31335048,-7533481
8245,2005,PNG,1815748452,3030592204,1214843752
8246,2005,POL,1.04E+11,85428247147,-18172126289
8247,2005,PRK,2404324584,1304410202,-1099914382
8248,2005,PRT,64122297302,38313402318,-25808894984
8249,2005,PRY,4032740482,2480448203,-1552292279
8250,2005,PSE,192697859,45387446,-147310413
8251,2005,PYF,1515280745,204098474,-1311182271
8252,2005,QAT,10190466598,25812302201,15621835603
8253,2005,ROU,40480585310,27659240363,-12821344947
8254,2005,RUS,1.30E+11,2.66E+11,1.37E+11
8255,2005,RWA,446015222,100612679,-345402543
8256,2005,SAU,54267226745,1.59E+11,1.05E+11
8257,2005,SDN,7354773050,6018542545,-1336230505
8258,2005,SEN,3669055047,1364897016,-2304158031
8259,2005,SGP,1.85E+11,2.24E+11,38709488869
8260,2005,SHN,63821313,13574359,-50246954
8261,2005,SLB,157892712,203316164,45423452
8262,2005,SLE,558880218,218412511,-340467707
8263,2005,SLV,6007700361,3641765593,-2365934768
8264,2005,SMR,169299306,35976551,-133322755
8265,2005,SOM,554729167,213972857,-340756310
8266,2005,SPM,46360735,11551364,-34809371
8267,2005,SRB,9312076322,0,-9312076322
8268,2005,STP,70401241,11486501,-58914740
8269,2005,SUR,978369959,774878682,-203491277
8270,2005,SVK,31767721076,31206745367,-560975709
8271,2005,SVN,19355491897,16829878379,-2525613518
8272,2005,SWE,1.11E+11,1.30E+11,18907471308
8273,2005,SWZ,1507795266,815984870,-691810396
8274,2005,SYC,685477702,458099059,-227378643
8275,2005,SYR,10099308004,7835057515,-2264250489
8276,2005,TCA,304511560,29328578,-275182982
8277,2005,TCD,385236674,2065065686,1679829012
8278,2005,TGO,1994663290,743989238,-1250674052
8279,2005,THA,1.11E+11,1.20E+11,8694818261
8280,2005,TJK,1050374574,755264673,-295109901
8281,2005,TKL,149302141,28962503,-120339638
8282,2005,TKM,2076672586,4701693758,2625021172
8283,2005,TLS,105701500,69892142,-35809358
8284,2005,TON,97191138,18854016,-78337122
8285,2005,TTO,5301082292,12154184388,6853102096
8286,2005,TUN,13398970167,10472464045,-2926506122
8287,2005,TUR,1.12E+11,72268841974,-40202152636
8288,2005,TUV,29174587,1098117,-28076470
8289,2005,TWN,1.93E+11,2.45E+11,52309748977
8290,2005,TZA,3825577722,1716116862,-2109460860
8291,2005,UGA,1925710209,914871421,-1010838788
8292,2005,UKR,40582756823,36745882215,-3836874608
8293,2005,URY,4869651884,4294712767,-574939117
8294,2005,USA,1.73E+12,9.19E+11,-8.10E+11
8295,2005,UZB,3292119062,3644687510,352568448
8296,2005,VAT,49931842,2123373,-47808469
8297,2005,VCT,528168253,178460010,-349708243
8298,2005,VEN,22645230115,55235133321,32589903206
8299,2005,VGB,4684689715,462677220,-4222012495
8300,2005,VNM,35116871101,35388379134,271508033
8301,2005,VUT,217874551,225156683,7282132
8302,2005,WLF,31454983,1070950,-30384033
8303,2005,WSM,228632048,29293420,-199338628
8304,2005,YEM,5767855991,5724330888,-43525103
8305,2005,ZAF,55894234723,61424588142,5530353419
8306,2005,ZMB,1699937768,2659193851,959256083
8307,2005,ZWE,3093453137,1989099548,-1104353589
8308,2006,ABW,3167481207,4082636280,915155073
8309,2006,AGO,10629861274,30441627639,19811766365
8310,2006,AIA,95409316,10362876,-85046440
8311,2006,ALB,2937368451,771643883,-2165724568
8312,2006,AND,1747069463,184588742,-1562480721
8313,2006,ANT,7580148318,3837795712,-3742352606
8314,2006,ARE,1.09E+11,1.10E+11,254295348
8315,2006,ARG,33275526437,47296880199,14021353762
8316,2006,ARM,2019037209,1070561391,-948475818
8317,2006,ASM,113440885,98853272,-14587613
8318,2006,ATA,14000877,1583603,-12417274
8319,2006,ATG,1381926153,343506764,-1038419389
8320,2006,AUS,1.30E+11,1.22E+11,-8292779762
8321,2006,AUT,1.38E+11,1.31E+11,-7300573253
8322,2006,AZE,7264471530,9069528063,1805056533
8323,2006,BDI,313763470,83700274,-230063196
8324,2006,BEL,3.43E+11,3.61E+11,18368651066
8325,2006,BEN,3300741595,592586294,-2708155301
8326,2006,BFA,1346479636,334854449,-1011625187
8327,2006,BGD,16336254066,13413825376,-2922428690
8328,2006,BGR,22147268179,15332957613,-6814310566
8329,2006,BHR,6083073598,6861677671,778604073
8330,2006,BHS,9445713457,2245830249,-7199883208
8331,2006,BIH,6304626970,3509318429,-2795308541
8332,2006,BLR,20877171728,20483605841,-393565887
8333,2006,BLZ,728176112,450591311,-277584801
8334,2006,BMU,4406878917,483831456,-3923047461
8335,2006,BOL,3540073751,3982332203,442258452
8336,2006,BRA,95527285857,1.48E+11,52423351991
8337,2006,BRB,1580144740,346211144,-1233933596
8338,2006,BRN,1813278228,7481761988,5668483760
8339,2006,BTN,118055753,181988408,63932655
8340,2006,BWA,3302329619,3513113567,210783948
8341,2006,CAF,187948764,119304678,-68644086
8342,2006,CAN,3.69E+11,3.88E+11,18914120302
8343,2006,CCK,7398091,5955013,-1443078
8344,2006,CHE,1.66E+11,1.54E+11,-12169853481
8345,2006,CHL,36642013077,61146555168,24504542091
8346,2006,CHN,8.03E+11,1.18E+12,3.80E+11
8347,2006,CIV,6013741243,8717837899,2704096656
8348,2006,CMR,3619263072,4712643099,1093380027
8349,2006,COD,2073473398,1410481619,-662991779
8350,2006,COG,1968619045,9019239406,7050620361
8351,2006,COK,75841441,16730666,-59110775
8352,2006,COL,26685916859,25635418819,-1050498040
8353,2006,COM,150207249,48280986,-101926263
8354,2006,CPV,657936918,49787265,-608149653
8355,2006,CRI,10767095232,14001413409,3234318177
8356,2006,CUB,6590505316,2873742736,-3716762580
8357,2006,CXR,40680233,18965876,-21714357
8358,2006,CYM,3408658456,1388620135,-2020038321
8359,2006,CYP,16926665514,4491364115,-12435301399
8360,2006,CZE,95555800428,91302837868,-4252962560
8361,2006,DEU,9.22E+11,1.10E+12,1.83E+11
8362,2006,DJI,1430961801,201114091,-1229847710
8363,2006,DMA,277702646,82990733,-194711913
8364,2006,DNK,83174425424,83028441556,-145983868
8365,2006,DOM,10885650320,6435952871,-4449697449
8366,2006,DZA,22810920094,49729291437,26918371343
8367,2006,ECU,11677935508,14679816283,3001880775
8368,2006,EGY,33536451196,20553887666,-12982563530
8369,2006,ERI,271552605,17352738,-254199867
8370,2006,ESH,1335132,3834570,2499438
8371,2006,ESP,3.51E+11,2.09E+11,-1.42E+11
8372,2006,EST,16555927855,10818208045,-5737719810
8373,2006,ETH,4354261116,1198380548,-3155880568
8374,2006,FIN,77999354488,79570174790,1570820302
8375,2006,FJI,1637295247,651639326,-985655921
8376,2006,FLK,66970357,148385731,81415374
8377,2006,FRA,5.91E+11,4.80E+11,-1.11E+11
8378,2006,FRO,705168397,687763532,-17404865
8379,2006,FSM,101704910,34557221,-67147689
8380,2006,GAB,1708023728,4614467214,2906443486
8381,2006,GBR,5.76E+11,4.54E+11,-1.21E+11
8382,2006,GEO,3825687149,1904321773,-1921365376
8383,2006,GHA,6986974437,3815869477,-3171104960
8384,2006,GIB,5172643491,164068014,-5008575477
8385,2006,GIN,1503623441,1358943472,-144679969
8386,2006,GMB,649426382,40191489,-609234893
8387,2006,GNB,155492454,50823509,-104668945
8388,2006,GNQ,1485872618,8020503195,6534630577
8389,2006,GRC,66270031634,21216649876,-45053381758
8390,2006,GRD,282943788,30355289,-252588499
8391,2006,GRL,641991674,562574344,-79417330
8392,2006,GTM,10285197770,6143419112,-4141778658
8393,2006,GUM,1118049153,87157326,-1030891827
8394,2006,GUY,950575834,634539950,-316035884
8395,2006,HKG,3.62E+11,3.11E+11,-51620690154
8396,2006,HND,6997715367,5180185444,-1817529923
8397,2006,HRV,21513732974,10640299692,-10873433282
8398,2006,HTI,2007018863,611049350,-1395969513
8399,2006,HUN,72698332962,72109440552,-588892410
8400,2006,IDN,85192114482,1.18E+11,32612531261
8401,2006,IND,1.61E+11,1.28E+11,-32765079481
8402,2006,IOT,27464442,3952235,-23512207
8403,2006,IRL,85693296660,1.37E+11,51475578144
8404,2006,IRN,39115630939,85906797278,46791166339
8405,2006,IRQ,12467802448,27951442940,15483640492
8406,2006,ISL,5129563465,3357505684,-1772057781
8407,2006,ISR,46578323889,45861863418,-716460471
8408,2006,ITA,4.16E+11,4.12E+11,-3924729407
8409,2006,JAM,5393034460,2201302472,-3191731988
8410,2006,JOR,12773910459,5033537589,-7740372870
8411,2006,JPN,5.52E+11,6.85E+11,1.33E+11
8412,2006,KAZ,26005451492,40698037197,14692585705
8413,2006,KEN,8684310536,3845616609,-4838693927
8414,2006,KGZ,3698686928,692137690,-3006549238
8415,2006,KHM,5075367802,3892855996,-1182511806
8416,2006,KIR,45310033,7681215,-37628818
8417,2006,KNA,291119188,67130397,-223988791
8418,2006,KOR,2.94E+11,3.37E+11,42849825438
8419,2006,KWT,17456592473,49800738553,32344146080
8420,2006,LAO,1472453174,1055220518,-417232656
8421,2006,LBN,9733550817,2387511213,-7346039604
8422,2006,LBR,6872307408,1640466264,-5231841144
8423,2006,LBY,9726871376,39167484385,29440613009
8424,2006,LCA,765143449,158143257,-607000192
8425,2006,LKA,10762278632,7311789201,-3450489431
8426,2006,LSO,264005191,517041686,253036495
8427,2006,LTU,18639872700,13889746543,-4750126157
8428,2006,LUX,25198780300,18271731033,-6927049267
8429,2006,LVA,12963840113,8228462890,-4735377223
8430,2006,MAC,5065977053,2746620629,-2319356424
8431,2006,MAR,24477446205,14475855269,-10001590936
8432,2006,MDA,2981009883,1384562276,-1596447607
8433,2006,MDG,1757453045,1152357854,-605095191
8434,2006,MDV,677084383,173025156,-504059227
8435,2006,MEX,2.41E+11,2.48E+11,7110185332
8436,2006,MHL,2965595601,1108438556,-1857157045
8437,2006,MKD,3781459777,2691401061,-1090058716
8438,2006,MLI,1825641427,536486585,-1289154842
8439,2006,MLT,7331200445,3990692813,-3340507632
8440,2006,MMR,3492971812,4572258151,1079286339
8441,2006,MNE,1815867611,633957448,-1181910163
8442,2006,MNG,1529322510,1529349902,27392
8443,2006,MNP,304486170,13596127,-290890043
8444,2006,MOZ,2694991343,2525542092,-169449251
8445,2006,MRT,1176972526,1654813276,477840750
8446,2006,MSR,24918867,3470572,-21448295
8447,2006,MUS,3669338855,2275285703,-1394053152
8448,2006,MWI,1140956053,683915036,-457041017
8449,2006,MYS,1.33E+11,1.88E+11,54952869084
8450,2006,MYT,317817311,3577660,-314239651
8451,2006,NAM,3011784157,3614694087,602909930
8452,2006,NCL,1801164909,1420632060,-380532849
8453,2006,NER,750212423,369998123,-380214300
8454,2006,NGA,23131863822,60816792945,37684929123
8455,2006,NIC,3370899415,2116767323,-1254132092
8456,2006,NIU,15000521,2415925,-12584596
8457,2006,NLD,4.39E+11,3.98E+11,-40947271089
8458,2006,NOR,67487216955,1.25E+11,57487996085
8459,2006,NPL,1479138174,598270537,-880867637
8460,2006,NRU,32602193,9524040,-23078153
8461,2006,NZL,25868203994,22604850600,-3263353394
8462,2006,OMN,11021748083,23342649486,12320901403
8463,2006,PAK,31122176968,16487526974,-14634649994
8464,2006,PAN,28276142113,9084529953,-19191612160
8465,2006,PCN,18093767,27127808,9034041
8466,2006,PER,16106833188,22761155018,6654321830
8467,2006,PHL,58701032258,71210104562,12509072304
8468,2006,PLW,44314849,40777030,-3537819
8469,2006,PNG,2088876064,3728525803,1639649739
8470,2006,POL,1.38E+11,1.07E+11,-31048853676
8471,2006,PRK,2710156747,1379892924,-1330263823
8472,2006,PRT,70214998379,45180792827,-25034205552
8473,2006,PRY,5493542191,2686121356,-2807420835
8474,2006,PSE,239828017,58249797,-181578220
8475,2006,PYF,1442938162,228031731,-1214906431
8476,2006,QAT,16321849581,35588598931,19266749350
8477,2006,ROU,56078963795,32489448070,-23589515725
8478,2006,RUS,1.65E+11,3.16E+11,1.51E+11
8479,2006,RWA,585244141,102981775,-482262366
8480,2006,SAU,65546424565,2.00E+11,1.35E+11
8481,2006,SDN,8596093963,5932801912,-2663292051
8482,2006,SEN,3920137190,1343334745,-2576802445
8483,2006,SGP,2.22E+11,2.71E+11,49256226453
8484,2006,SHN,74244918,13461616,-60783302
8485,2006,SLB,196858618,232795093,35936475
8486,2006,SLE,476092604,276290885,-199801719
8487,2006,SLV,7211157671,3708935355,-3502222316
8488,2006,SMR,185297301,50364650,-134932651
8489,2006,SOM,695830100,237971857,-457858243
8490,2006,SPM,47767172,28330213,-19436959
8491,2006,SRB,13421431110,6358144274,-7063286836
8492,2006,STP,87401453,18167802,-69233651
8493,2006,SUR,1107094649,990073713,-117020936
8494,2006,SVK,43920390405,40257088101,-3663302304
8495,2006,SVN,23132271700,20478750715,-2653520985
8496,2006,SWE,1.28E+11,1.47E+11,18834059887
8497,2006,SWZ,1175930602,904260950,-271669652
8498,2006,SYC,722044467,433692278,-288352189
8499,2006,SYR,12765982382,11532478829,-1233503553
8500,2006,TCA,459574290,32986674,-426587616
8501,2006,TCD,419373813,2387840067,1968466254
8502,2006,TGO,2529272377,626063640,-1903208737
8503,2006,THA,1.24E+11,1.39E+11,15546924926
8504,2006,TJK,1497826307,857019115,-640807192
8505,2006,TKL,126290117,18989908,-107300209
8506,2006,TKM,1842741357,5185415436,3342674079
8507,2006,TLS,109336530,35375759,-73960771
8508,2006,TON,99834603,22050883,-77783720
8509,2006,TTO,6365420822,14828823294,8463402472
8510,2006,TUN,15943694371,12672504818,-3271189553
8511,2006,TUR,1.34E+11,84296692386,-49533460269
8512,2006,TUV,43093337,3792888,-39300449
8513,2006,TWN,2.14E+11,2.83E+11,68642369778
8514,2006,TZA,4672382281,1909092019,-2763290262
8515,2006,UGA,2263783390,1055760344,-1208023046
8516,2006,UKR,53386615378,41215270895,-12171344483
8517,2006,URY,6061049778,4559591547,-1501458231
8518,2006,USA,1.91E+12,1.05E+12,-8.60E+11
8519,2006,UZB,4128447439,5191192972,1062745533
8520,2006,VAT,44207410,4279263,-39928147
8521,2006,VCT,541521943,230593927,-310928016
8522,2006,VEN,31816648028,60367059488,28550411460
8523,2006,VGB,4365900809,363553113,-4002347696
8524,2006,VNM,42835828022,42815265164,-20562858
8525,2006,VUT,213800238,270352686,56552448
8526,2006,WLF,37702479,1276340,-36426139
8527,2006,WSM,252939264,84165394,-168773870
8528,2006,YEM,7493653252,7539246465,45593213
8529,2006,ZAF,69170561707,70237584170,1067022463
8530,2006,ZMB,4054566142,4606542321,551976179
8531,2006,ZWE,2223918800,4410709946,2186791146
8532,2007,ABW,2766474760,4445280182,1678805422
8533,2007,AGO,14180147283,39271089606,25090942323
8534,2007,AIA,166845882,14193717,-152652165
8535,2007,ALB,4054571154,1100750774,-2953820380
8536,2007,AND,1882950917,160874941,-1722075976
8537,2007,ANT,4795898719,3872631500,-923267219
8538,2007,ARE,1.34E+11,1.39E+11,4297860413
8539,2007,ARG,43655270235,58158793316,14503523081
8540,2007,ARM,2771916768,1209913453,-1562003315
8541,2007,ASM,184900799,69818938,-115081861
8542,2007,ATA,15833016,1457302,-14375714
8543,2007,ATG,1833914747,190069184,-1643845563
8544,2007,AUS,1.56E+11,1.42E+11,-14093228031
8545,2007,AUT,1.58E+11,1.54E+11,-3393663032
8546,2007,AZE,7910415231,15117539727,7207124496
8547,2007,BDI,443168169,86372088,-356796081
8548,2007,BEL,3.93E+11,4.23E+11,30602576059
8549,2007,BEN,4855394930,730363712,-4125031218
8550,2007,BFA,1447457760,661978489,-785479271
8551,2007,BGD,17948902577,14328480039,-3620422538
8552,2007,BGR,29388961099,17620725505,-11768235594
8553,2007,BHR,7992258204,7315901753,-676356451
8554,2007,BHS,8849383259,2210613558,-6638769701
8555,2007,BIH,7997173297,4033768218,-3963405079
8556,2007,BLR,26699639543,25603125083,-1096514460
8557,2007,BLZ,822692799,421417880,-401274919
8558,2007,BMU,4333719765,244626750,-4089093015
8559,2007,BOL,4306491472,4414426988,107935516
8560,2007,BRA,1.26E+11,1.76E+11,50325061244
8561,2007,BRB,1496046964,523292288,-972754676
8562,2007,BRN,3598375556,7359132791,3760757235
8563,2007,BTN,165061314,301502223,136440909
8564,2007,BWA,4185198467,2756645121,-1428553346
8565,2007,CAF,217483549,132771382,-84712167
8566,2007,CAN,4.06E+11,4.14E+11,7833904913
8567,2007,CCK,12734025,5437395,-7296630
8568,2007,CHE,1.96E+11,1.82E+11,-13766533490
8569,2007,CHL,43941385905,70821987865,26880601960
8570,2007,CHN,8.12E+11,1.45E+12,6.40E+11
8571,2007,CIV,6281837190,9105222227,2823385037
8572,2007,CMR,4062304163,5381441755,1319137592
8573,2007,COD,2853720171,1990201141,-863519030
8574,2007,COG,3762455014,8797911368,5035456354
8575,2007,COK,116250923,15285866,-100965057
8576,2007,COL,32882518595,31920541262,-961977333
8577,2007,COM,161980935,40829163,-121151772
8578,2007,CPV,829327434,47908987,-781418447
8579,2007,CRI,12267664676,16142471724,3874807048
8580,2007,CUB,6568488951,3454507051,-3113981900
8581,2007,CXR,31378552,27651010,-3727542
8582,2007,CYM,2334060497,312101405,-2021959092
8583,2007,CYP,18146394824,3632156640,-14514238184
8584,2007,CZE,1.21E+11,1.18E+11,-3256015914
8585,2007,DEU,1.03E+12,1.31E+12,2.78E+11
8586,2007,DJI,1737125075,180096667,-1557028408
8587,2007,DMA,311875865,89124777,-222751088
8588,2007,DNK,92888792840,91851803209,-1036989631
8589,2007,DOM,13113351571,6703706237,-6409645334
8590,2007,DZA,29794983265,53971734036,24176750771
8591,2007,ECU,13445182816,16154944247,2709761431
8592,2007,EGY,43079557721,24013100917,-19066456804
8593,2007,ERI,347309427,74992936,-272316491
8594,2007,ESH,877110,5156916,4279806
8595,2007,ESP,4.03E+11,2.48E+11,-1.55E+11
8596,2007,EST,18007203109,11825186549,-6182016560
8597,2007,ETH,5234509581,1330151604,-3904357977
8598,2007,FIN,89752155532,90887559723,1135404191
8599,2007,FJI,1639521451,808181201,-831340250
8600,2007,FLK,92788845,171746907,78958062
8601,2007,FRA,6.63E+11,5.40E+11,-1.23E+11
8602,2007,FRO,953384268,758568153,-194816115
8603,2007,FSM,119540065,22999059,-96541006
8604,2007,GAB,2516094477,6410882069,3894787592
8605,2007,GBR,6.45E+11,4.55E+11,-1.90E+11
8606,2007,GEO,5259907940,1849854371,-3410053569
8607,2007,GHA,8748948002,4083723234,-4665224768
8608,2007,GIB,6281963592,280141320,-6001822272
8609,2007,GIN,1746370144,2232032019,485661875
8610,2007,GMB,786153709,47243899,-738909810
8611,2007,GNB,204526275,80751455,-123774820
8612,2007,GNQ,1426165839,9023405870,7597240031
8613,2007,GRC,78174286034,23940638132,-54233647902
8614,2007,GRD,301970094,52869359,-249100735
8615,2007,GRL,714056584,643133055,-70923529
8616,2007,GTM,12365320724,7137418682,-5227902042
8617,2007,GUM,998296281,127688271,-870608010
8618,2007,GUY,933471304,790235468,-143235836
8619,2007,HKG,3.98E+11,1.21E+11,-2.78E+11
8620,2007,HND,8939976541,5804101193,-3135875348
8621,2007,HRV,26452776313,12539932052,-13912844261
8622,2007,HTI,2005113505,632758232,-1372355273
8623,2007,HUN,91574179855,91275166867,-299012988
8624,2007,IDN,1.05E+11,1.33E+11,27816613483
8625,2007,IND,2.19E+11,1.66E+11,-53198619975
8626,2007,IOT,21377269,4157722,-17219547
8627,2007,IRL,95296179434,1.53E+11,57790509962
8628,2007,IRN,50721589467,75908439568,25186850101
8629,2007,IRQ,13672527862,34537241438,20864713576
8630,2007,ISL,6154402732,3900349605,-2254053127
8631,2007,ISR,56217931474,55292091635,-925839839
8632,2007,ITA,4.91E+11,4.93E+11,1949804397
8633,2007,JAM,6267288577,2377321582,-3889966995
8634,2007,JOR,14595733269,5546253267,-9049480002
8635,2007,JPN,5.87E+11,7.58E+11,1.71E+11
8636,2007,KAZ,36156596460,48579386779,12422790319
8637,2007,KEN,9935268624,4381666372,-5553602252
8638,2007,KGZ,5934264849,979690261,-4954574588
8639,2007,KHM,5941235563,4480349150,-1460886413
8640,2007,KIR,73523316,10631518,-62891798
8641,2007,KNA,272329954,73668332,-198661622
8642,2007,KOR,3.34E+11,3.77E+11,42471618599
8643,2007,KWT,22221538765,56292912550,34071373785
8644,2007,LAO,1878341657,1139545929,-738795728
8645,2007,LBN,11619981733,3027554589,-8592427144
8646,2007,LBR,7872364814,999104859,-6873259955
8647,2007,LBY,12361619587,43981571234,31619951647
8648,2007,LCA,1604598142,132621336,-1471976806
8649,2007,LKA,11724394075,8161239997,-3563154078
8650,2007,LSO,271993128,677002794,405009666
8651,2007,LTU,23743837462,16907989589,-6835847873
8652,2007,LUX,25066871796,20751062606,-4315809190
8653,2007,LVA,18332615567,9943972716,-8388642851
8654,2007,MAC,6340194442,2731011254,-3609183188
8655,2007,MAR,32177555366,17572366790,-14605188576
8656,2007,MDA,4098021412,1959896777,-2138124635
8657,2007,MDG,2474211004,1329789361,-1144421643
8658,2007,MDV,859093504,155774193,-703319311
8659,2007,MEX,2.60E+11,2.79E+11,18834622022
8660,2007,MHL,5433320406,546062475,-4887257931
8661,2007,MKD,4781143860,3789969593,-991174267
8662,2007,MLI,2155019481,431071433,-1723948048
8663,2007,MLT,8527949629,5185454729,-3342494900
8664,2007,MMR,5027474923,4874591069,-152883854
8665,2007,MNE,2543896488,628550527,-1915345961
8666,2007,MNG,2195438043,1758922036,-436516007
8667,2007,MNP,169341943,14959824,-154382119
8668,2007,MOZ,3516311735,3029503846,-486807889
8669,2007,MRT,1611431205,1745933865,134502660
8670,2007,MSR,19895469,3431226,-16464243
8671,2007,MUS,4123771139,2236322657,-1887448482
8672,2007,MWI,1183298722,981621841,-201676881
8673,2007,MYS,1.51E+11,2.13E+11,61531437408
8674,2007,MYT,491629091,6841380,-484787711
8675,2007,NAM,4201329317,3807982586,-393346731
8676,2007,NCL,2361337415,2445742859,84405444
8677,2007,NER,1009455291,291086815,-718368476
8678,2007,NGA,32374123560,66599731557,34225607997
8679,2007,NIC,4290534474,2456507541,-1834026933
8680,2007,NIU,15702185,2886390,-12815795
8681,2007,NLD,5.04E+11,4.75E+11,-29169265901
8682,2007,NOR,83848371446,1.36E+11,52314085496
8683,2007,NPL,2063371085,759199470,-1304171615
8684,2007,NRU,45996349,25308427,-20687922
8685,2007,NZL,30428121983,26949184898,-3478937085
8686,2007,OMN,16004522747,24616112300,8611589553
8687,2007,PAK,34155726272,18479532548,-15676193724
8688,2007,PAN,35330178731,9482101248,-25848077483
8689,2007,PCN,8451651,5509655,-2941996
8690,2007,PER,20561894522,28089773455,7527878933
8691,2007,PHL,66531498712,77312030296,10780531584
8692,2007,PLW,81457175,31431398,-50025777
8693,2007,PNG,2627587809,4404053175,1776465366
8694,2007,POL,1.77E+11,1.35E+11,-42458536845
8695,2007,PRK,3142523808,2621013597,-521510211
8696,2007,PRT,79565973951,50146775596,-29419198355
8697,2007,PRY,6839138279,3646555389,-3192582890
8698,2007,PSE,2548772698,520654372,-2028118326
8699,2007,PYF,1617626884,244802044,-1372824840
8700,2007,QAT,23375235548,41467600711,18092365163
8701,2007,ROU,63889087622,39080593667,-24808493955
8702,2007,RUS,2.32E+11,3.93E+11,1.61E+11
8703,2007,RWA,644202464,192758294,-451444170
8704,2007,SAU,85406687912,3.22E+11,2.37E+11
8705,2007,SDN,7091466262,8103667315,1012201053
8706,2007,SEN,5285485473,1642947313,-3642538160
8707,2007,SGP,2.52E+11,2.91E+11,38822846271
8708,2007,SHN,77410042,21878708,-55531334
8709,2007,SLB,264015496,315663729,51648233
8710,2007,SLE,623298169,381175736,-242122433
8711,2007,SLV,8704510790,4136708110,-4567802680
8712,2007,SMR,431097356,196124527,-234972829
8713,2007,SOM,822252722,211923396,-610329326
8714,2007,SPM,52156409,17014685,-35141724
8715,2007,SRB,18222430771,8815448149,-9406982622
8716,2007,STP,107782805,11258396,-96524409
8717,2007,SUR,1201497248,1354001618,152504370
8718,2007,SVK,59560112604,55871223437,-3688889167
8719,2007,SVN,29721320297,26174061212,-3547259085
8720,2007,SWE,1.50E+11,1.68E+11,18326201559
8721,2007,SWZ,1237654734,985818874,-251835860
8722,2007,SYC,925859954,406896341,-518963613
8723,2007,SYR,17142303048,10816225905,-6326077143
8724,2007,TCA,482216158,89650574,-392565584
8725,2007,TCD,632944405,2389002962,1756058557
8726,2007,TGO,4095452615,1249620801,-2845831814
8727,2007,THA,1.38E+11,1.64E+11,26150471474
8728,2007,TJK,2054349716,1040242165,-1014107551
8729,2007,TKL,179240100,25235538,-154004562
8730,2007,TKM,2429847924,6172228755,3742380831
8731,2007,TLS,113025880,29331727,-83694153
8732,2007,TON,143525348,17248066,-126277282
8733,2007,TTO,7275436791,15663669491,8388232700
8734,2007,TUN,19525682102,16124831513,-3400850589
8735,2007,TUR,1.61E+11,1.09E+11,-52241881321
8736,2007,TUV,37940673,1336656,-36604017
8737,2007,TWN,3.34E+11,3.15E+11,-19454165344
8738,2007,TZA,6291179212,2187933403,-4103245809
8739,2007,UGA,3145725770,1510284950,-1635440820
8740,2007,UKR,71894849309,52576063142,-19318786167
8741,2007,URY,6568551923,5362132294,-1206419629
8742,2007,USA,1.98E+12,1.16E+12,-8.19E+11
8743,2007,UZB,6375297267,6119721453,-255575814
8744,2007,VAT,54348502,5088903,-49259599
8745,2007,VCT,547152729,149820112,-397332617
8746,2007,VEN,42178141442,60186620209,18008478767
8747,2007,VGB,3863482148,411518587,-3451963561
8748,2007,VNM,61390153792,51931727319,-9458426473
8749,2007,VUT,254273839,286009059,31735220
8750,2007,WLF,27174641,1078683,-26095958
8751,2007,WSM,269702185,104298260,-165403925
8752,2007,YEM,9768077144,7637638298,-2130438846
8753,2007,ZAF,80292078126,86398060187,6105982061
8754,2007,ZMB,3582225288,5927149577,2344924289
8755,2007,ZWE,2985420414,3650424374,665003960
8756,2008,ABW,2730145619,5313331575,2583185956
8757,2008,AGO,20427684165,64389926355,43962242190
8758,2008,AIA,163227536,12480203,-150747333
8759,2008,ALB,5042704659,2207156748,-2835547911
8760,2008,AND,1993575740,173465507,-1820110233
8761,2008,ANT,6630152983,3057591827,-3572561156
8762,2008,ARE,1.82E+11,2.08E+11,25418200401
8763,2008,ARG,54008995206,76832059057,22823063851
8764,2008,ARM,3457964337,977029601,-2480934736
8765,2008,ASM,267016795,68797052,-198219743
8766,2008,ATA,1494627320,2493284,-1492134036
8767,2008,ATG,2083445961,353566757,-1729879204
8768,2008,AUS,1.86E+11,1.87E+11,1132327313
8769,2008,AUT,1.73E+11,1.68E+11,-4793667565
8770,2008,AZE,10743072624,31746037944,21002965320
8771,2008,BDI,319152240,59981300,-259170940
8772,2008,BEL,4.48E+11,4.62E+11,14009707600
8773,2008,BEN,6460859512,780012609,-5680846903
8774,2008,BFA,1590113398,642291177,-947822221
8775,2008,BGD,23556258043,18198705542,-5357552501
8776,2008,BGR,37225001715,21787025060,-15437976655
8777,2008,BHR,11699392684,9877811535,-1821581149
8778,2008,BHS,9873349739,2591897965,-7281451774
8779,2008,BIH,10247049494,4763344449,-5483705045
8780,2008,BLR,37012279692,28595221628,-8417058064
8781,2008,BLZ,1234247592,455243051,-779004541
8782,2008,BMU,4420562231,480006224,-3940556007
8783,2008,BOL,5851143847,6899109344,1047965497
8784,2008,BRA,1.78E+11,2.22E+11,43923424792
8785,2008,BRB,2062783728,634609052,-1428174676
8786,2008,BRN,2398740372,10664958578,8266218206
8787,2008,BTN,207592647,169902941,-37689706
8788,2008,BWA,5001050766,2574755063,-2426295703
8789,2008,CAF,335297807,164135445,-171162362
8790,2008,CAN,4.35E+11,4.58E+11,23036738669
8791,2008,CCK,10509278,28314964,17805686
8792,2008,CHE,2.25E+11,2.17E+11,-7936567300
8793,2008,CHL,58797888279,70186846105,11388957826
8794,2008,CHN,1.13E+12,1.66E+12,5.28E+11
8795,2008,CIV,7787109833,11297008495,3509898662
8796,2008,CMR,4454469224,5644985792,1190516568
8797,2008,COD,3903132133,3575576678,-327555455
8798,2008,COG,4237352776,13226553662,8989200886
8799,2008,COK,100956810,29152048,-71804762
8800,2008,COL,38811114858,42752359347,3941244489
8801,2008,COM,256177545,33831298,-222346247
8802,2008,CPV,925056068,51271947,-873784121
8803,2008,CRI,15300893448,17264741225,1963847777
8804,2008,CUB,8639261961,3016613436,-5622648525
8805,2008,CXR,36008603,53340449,17331846
8806,2008,CYM,3173091158,486427543,-2686663615
8807,2008,CYP,18834209732,3779723553,-15054486179
8808,2008,CZE,1.39E+11,1.39E+11,639216544
8809,2008,DEU,1.18E+12,1.44E+12,2.67E+11
8810,2008,DJI,2098853945,224125722,-1874728223
8811,2008,DMA,366522133,96260618,-270261515
8812,2008,DNK,1.05E+11,1.06E+11,868207815
8813,2008,DOM,14244410788,6973255258,-7271155530
8814,2008,DZA,41422992287,70407601619,28984609332
8815,2008,ECU,17931634747,22359577422,4427942675
8816,2008,EGY,57999149045,32435845132,-25563303913
8817,2008,ERI,265695600,25740140,-239955460
8818,2008,ESH,1873547,10739055,8865508
8819,2008,ESP,4.28E+11,2.71E+11,-1.57E+11
8820,2008,EST,18799865141,13702644584,-5097220557
8821,2008,ETH,7417202678,1654731490,-5762471188
8822,2008,FIN,1.02E+11,97757338669,-3873937877
8823,2008,FJI,2099605437,891364136,-1208241301
8824,2008,FLK,80545424,189300599,108755175
8825,2008,FRA,7.56E+11,5.96E+11,-1.60E+11
8826,2008,FRO,920083736,962139486,42055750
8827,2008,FSM,141118068,28486725,-112631343
8828,2008,GAB,2871568505,8206359684,5334791179
8829,2008,GBR,6.93E+11,4.84E+11,-2.09E+11
8830,2008,GEO,7071427144,2535291147,-4536135997
8831,2008,GHA,11789566042,5061974287,-6727591755
8832,2008,GIB,9088620981,218265785,-8870355196
8833,2008,GIN,2336142949,1888900005,-447242944
8834,2008,GMB,828390430,56549883,-771840547
8835,2008,GNB,239866116,130396141,-109469975
8836,2008,GNQ,1716001488,15395626538,13679625050
8837,2008,GRC,93327644859,29913233487,-63414411372
8838,2008,GRD,303071440,41161956,-261909484
8839,2008,GRL,939684459,748242744,-191441715
8840,2008,GTM,13616333835,8413220105,-5203113730
8841,2008,GUM,936014257,135403698,-800610559
8842,2008,GUY,1415016915,900935077,-514081838
8843,2008,HKG,4.27E+11,3.58E+11,-68335087896
8844,2008,HND,9619329434,6369122599,-3250206835
8845,2008,HRV,31641368971,14385422433,-17255946538
8846,2008,HTI,2516912087,628873266,-1888038821
8847,2008,HUN,1.01E+11,1.05E+11,3301234008
8848,2008,IDN,1.41E+11,1.62E+11,20862755758
8849,2008,IND,3.01E+11,2.07E+11,-94180986579
8850,2008,IOT,16080778,7899695,-8181083
8851,2008,IRL,90232521483,1.56E+11,65957919344
8852,2008,IRN,58817779655,1.03E+11,43947522544
8853,2008,IRQ,21099328161,56661332666,35562004505
8854,2008,ISL,5020283340,4176121591,-844161749
8855,2008,ISR,67426434338,63670524706,-3755909632
8856,2008,ITA,5.27E+11,5.34E+11,6735420056
8857,2008,JAM,7656635236,2656184064,-5000451172
8858,2008,JOR,19459689459,7852251811,-11607437648
8859,2008,JPN,7.09E+11,8.24E+11,1.16E+11
8860,2008,KAZ,40826105156,69249868030,28423762874
8861,2008,KEN,12505068149,5303760310,-7201307839
8862,2008,KGZ,12182873805,1447677140,-10735196665
8863,2008,KHM,7577988038,5615570594,-1962417444
8864,2008,KIR,56214465,25881454,-30333011
8865,2008,KNA,292031681,75105647,-216926034
8866,2008,KOR,4.16E+11,4.35E+11,19224410614
8867,2008,KWT,24263726607,82477901981,58214175374
8868,2008,LAO,2526923161,1387288216,-1139634945
8869,2008,LBN,16406984951,3815823306,-12591161645
8870,2008,LBR,10719105492,1164729428,-9554376064
8871,2008,LBY,18450236049,60932653122,42482417073
8872,2008,LCA,4209367539,117688245,-4091679294
8873,2008,LKA,14440483588,9051406774,-5389076814
8874,2008,LSO,1327259374,636196377,-691062997
8875,2008,LTU,30957229993,24604380558,-6352849435
8876,2008,LUX,29481740700,23280787332,-6200953368
8877,2008,LVA,22272671967,11449355633,-10823316334
8878,2008,MAC,6859788151,2373060815,-4486727336
8879,2008,MAR,41486119566,22755366295,-18730753271
8880,2008,MDA,5384120244,2457661277,-2926458967
8881,2008,MDG,3467841394,1362200859,-2105640535
8882,2008,MDV,1125732832,188674543,-937058289
8883,2008,MEX,2.97E+11,2.96E+11,-1886065047
8884,2008,MHL,9432450209,1559042978,-7873407231
8885,2008,MKD,5283425254,3775414317,-1508010937
8886,2008,MLI,2518231219,508679204,-2009552015
8887,2008,MLT,12842317373,7654392628,-5187924745
8888,2008,MMR,6302380095,6482871275,180491180
8889,2008,MNE,3636341787,639273031,-2997068756
8890,2008,MNG,3094983801,1949673467,-1145310334
8891,2008,MNP,126732451,14342641,-112389810
8892,2008,MOZ,4180364242,2853697423,-1326666819
8893,2008,MRT,2129130269,2439411949,310281680
8894,2008,MSR,20720951,4843340,-15877611
8895,2008,MUS,4553647247,2293216648,-2260430599
8896,2008,MWI,2044740343,930156393,-1114583950
8897,2008,MYS,1.68E+11,2.41E+11,73159711515
8898,2008,MYT,530449755,12572453,-517877302
8899,2008,NAM,4777760721,4207235586,-570525135
8900,2008,NCL,2766475937,1395414179,-1371061758
8901,2008,NER,1424276312,429861520,-994414792
8902,2008,NGA,45061406882,90623792576,45562385694
8903,2008,NIC,4712953410,2883780732,-1829172678
8904,2008,NIU,30659296,8912841,-21746455
8905,2008,NLD,5.93E+11,5.45E+11,-47687057174
8906,2008,NOR,93475543572,1.78E+11,84798295765
8907,2008,NPL,2558129906,953447177,-1604682729
8908,2008,NRU,91311882,129108412,37796530
8909,2008,NZL,33007432455,30750944697,-2256487758
8910,2008,OMN,24030829160,36765404479,12734575319
8911,2008,PAK,42174305493,20907386290,-21266919203
8912,2008,PAN,48743718397,11429065754,-37314652643
8913,2008,PCN,7625092,8997619,1372527
8914,2008,PER,29648168263,30157163627,508995364
8915,2008,PHL,74797613534,73136094327,-1661519207
8916,2008,PLW,116471827,28851683,-87620144
8917,2008,PNG,3083791505,5185255753,2101464248
8918,2008,POL,2.22E+11,1.65E+11,-57025387392
8919,2008,PRK,4310801987,2093656424,-2217145563
8920,2008,PRT,90868982272,55056022184,-35812960088
8921,2008,PRY,8580827386,6085661544,-2495165842
8922,2008,PSE,3069670617,570326432,-2499344185
8923,2008,PYF,1779129862,225731625,-1553398237
8924,2008,QAT,29876538408,67478520954,37601982546
8925,2008,ROU,77997211694,47089351035,-30907860659
8926,2008,RUS,2.97E+11,4.87E+11,1.89E+11
8927,2008,RWA,1030706766,409768140,-620938626
8928,2008,SAU,1.07E+11,4.63E+11,3.56E+11
8929,2008,SDN,13406678130,12861571918,-545106212
8930,2008,SEN,7553589755,1934087642,-5619502113
8931,2008,SGP,3.06E+11,3.36E+11,29458245449
8932,2008,SHN,50790786,41767006,-9023780
8933,2008,SLB,280034850,368349695,88314845
8934,2008,SLE,752560891,347604139,-404956752
8935,2008,SLV,8747573878,4730632982,-4016940896
8936,2008,SMR,436823210,220810912,-216012298
8937,2008,SOM,947150792,177046603,-770104189
8938,2008,SPM,51627754,14732034,-36895720
8939,2008,SRB,22453724450,11083465589,-11370258861
8940,2008,STP,123597794,9082494,-114515300
8941,2008,SUR,1645617953,1559507988,-86109965
8942,2008,SVK,72460472573,66501881596,-5958590977
8943,2008,SVN,34053142300,29157164070,-4895978230
8944,2008,SWE,1.65E+11,1.83E+11,17466783353
8945,2008,SWZ,314729896,1039575897,724846001
8946,2008,SYC,944076403,405529203,-538547200
8947,2008,SYR,21048455148,14441954076,-6606501072
8948,2008,TCA,511516246,68311433,-443204813
8949,2008,TCD,768717682,3727477026,2958759344
8950,2008,TGO,3568768873,1944394110,-1624374763
8951,2008,THA,1.64E+11,1.90E+11,25090044770
8952,2008,TJK,3389204157,980027786,-2409176371
8953,2008,TKL,130503913,26094558,-104409355
8954,2008,TKM,4119657975,7718770684,3599112709
8955,2008,TLS,334271409,161160654,-173110755
8956,2008,TON,179953515,16631768,-163321747
8957,2008,TTO,9731621668,21706990463,11975368795
8958,2008,TUN,24883366507,20114635347,-4768731160
8959,2008,TUR,1.91E+11,1.34E+11,-57233688336
8960,2008,TUV,106236184,3929390,-102306794
8961,2008,TWN,4.25E+11,3.19E+11,-1.06E+11
8962,2008,TZA,8329347099,2836238846,-5493108253
8963,2008,UGA,4049935260,1902355048,-2147580212
8964,2008,UKR,96469907356,75703666448,-20766240908
8965,2008,URY,9978317380,7068420326,-2909897054
8966,2008,USA,2.15E+12,1.30E+12,-8.48E+11
8967,2008,UZB,9102795316,7723430237,-1379365079
8968,2008,VAT,42887126,2528298,-40358828
8969,2008,VCT,703225265,248039123,-455186142
8970,2008,VEN,49329436383,87553747210,38224310827
8971,2008,VGB,3190458200,528515286,-2661942914
8972,2008,VNM,76877665816,67900622128,-8977043688
8973,2008,VUT,388053393,526387504,138334111
8974,2008,WLF,36184746,17819691,-18365055
8975,2008,WSM,282375523,87016811,-195358712
8976,2008,YEM,11198358669,10447245097,-751113572
8977,2008,ZAF,91757790788,1.08E+11,16078839642
8978,2008,ZMB,4488635120,6681437480,2192802360
8979,2008,ZWE,2772861375,2444234754,-328626621
8980,2009,ABW,1151479940,2090571244,939091304
8981,2009,AGO,22004946084,38535029181,16530083097
8982,2009,AIA,113430812,30621509,-82809303
8983,2009,ALB,4751344854,3623834889,-1127509965
8984,2009,AND,1722457507,169652424,-1552805083
8985,2009,ANT,4711888500,3129143460,-1582745040
8986,2009,ARE,1.44E+11,1.29E+11,-14977937126
8987,2009,ARG,38221502935,57030530024,18809027089
8988,2009,ARM,2516464248,663135741,-1853328507
8989,2009,ASM,136904144,30227357,-106676787
8990,2009,ATA,112890284,4050806,-108839478
8991,2009,ATG,1895643516,243583151,-1652060365
8992,2009,AUS,1.47E+11,1.51E+11,3259023916
8993,2009,AUT,1.45E+11,1.29E+11,-16321436406
8994,2009,AZE,8008842822,18989774223,10980931401
8995,2009,BDI,355845026,78669875,-277175151
8996,2009,BEL,3.39E+11,3.62E+11,23248462810
8997,2009,BEN,5675054514,614714365,-5060340149
8998,2009,BFA,1790014659,758788015,-1031226644
8999,2009,BGD,22664470337,17297784224,-5366686113
9000,2009,BGR,24261325313,16161169768,-8100155545
9001,2009,BHR,9296024906,6432075694,-2863949212
9002,2009,BHS,8265716268,2355993661,-5909722607
9003,2009,BIH,7551943177,3584521904,-3967421273
9004,2009,BLR,26606333374,18228940522,-8377392852
9005,2009,BLZ,1330785289,362937458,-967847831
9006,2009,BMU,2580749917,201789959,-2378959958
9007,2009,BOL,5228678768,5225471739,-3207029
9008,2009,BRA,1.32E+11,1.69E+11,36647208410
9009,2009,BRB,2436681294,1036511068,-1400170226
9010,2009,BRN,2333721503,6679552021,4345830518
9011,2009,BTN,188517425,151650646,-36866779
9012,2009,BWA,4669198919,2199602051,-2469596868
9013,2009,CAF,244137047,109407888,-134729159
9014,2009,CAN,3.47E+11,3.16E+11,-30996477311
9015,2009,CCK,34755147,5161895,-29593252
9016,2009,CHE,1.88E+11,1.91E+11,3199095706
9017,2009,CHL,39959218766,55697910644,15738691878
9018,2009,CHN,8.66E+11,1.42E+12,5.59E+11
9019,2009,CIV,6767695729,10876895193,4109199464
9020,2009,CMR,4393101687,3693134992,-699966695
9021,2009,COD,3191860542,2666451899,-525408643
9022,2009,COG,4764504327,9013735868,4249231541
9023,2009,COK,108430696,19855991,-88574705
9024,2009,COL,31698335151,33796106310,2097771159
9025,2009,COM,199905804,31010785,-168895019
9026,2009,CPV,733661296,52311217,-681350079
9027,2009,CRI,10488194792,18560639351,8072444559
9028,2009,CUB,5011326287,2246131995,-2765194292
9029,2009,CXR,33654103,11777016,-21877087
9030,2009,CYM,2667852949,204529681,-2463323268
9031,2009,CYP,13688424869,2886050018,-10802374851
9032,2009,CZE,1.11E+11,1.10E+11,-944763634
9033,2009,DEU,9.10E+11,1.12E+12,2.13E+11
9034,2009,DJI,1927083017,154643489,-1772439528
9035,2009,DMA,264960562,122321076,-142639486
9036,2009,DNK,79784113461,85164946600,5380833139
9037,2009,DOM,12370589669,5714676917,-6655912752
9038,2009,DZA,39147308404,47969386383,8822077979
9039,2009,ECU,14383961878,17205461012,2821499134
9040,2009,EGY,51247217226,25947892401,-25299324825
9041,2009,ERI,336993720,35914281,-301079439
9042,2009,ESH,17713000,1233248,-16479752
9043,2009,ESP,2.96E+11,2.18E+11,-77869237648
9044,2009,EST,12286148653,10236332408,-2049816245
9045,2009,ETH,7315027804,1677309839,-5637717965
9046,2009,FIN,65416515078,65803393148,386878070
9047,2009,FJI,1279599888,745221351,-534378537
9048,2009,FLK,59745507,139357179,79611672
9049,2009,FRA,5.98E+11,4.68E+11,-1.30E+11
9050,2009,FRO,679433336,681157311,1723975
9051,2009,FSM,170648089,50694488,-119953601
9052,2009,GAB,2499886273,4712043431,2212157158
9053,2009,GBR,5.39E+11,3.56E+11,-1.83E+11
9054,2009,GEO,4720808435,1714965242,-3005843193
9055,2009,GHA,8892786124,5081434329,-3811351795
9056,2009,GIB,7649061480,276212503,-7372848977
9057,2009,GIN,2031298103,1044877851,-986420252
9058,2009,GMB,799146510,103259864,-695886646
9059,2009,GNB,296744001,98028127,-198715874
9060,2009,GNQ,3303252121,8742818086,5439565965
9061,2009,GRC,71034899624,23222805121,-47812094503
9062,2009,GRD,209788719,39400474,-170388245
9063,2009,GRL,665295239,609854437,-55440802
9064,2009,GTM,11193939500,7620343315,-3573596185
9065,2009,GUM,885402555,97126569,-788275986
9066,2009,GUY,1151422765,763497236,-387925529
9067,2009,HKG,3.75E+11,1.01E+11,-2.75E+11
9068,2009,HND,7359245217,5360685656,-1998559561
9069,2009,HRV,21875850445,10674460412,-11201390033
9070,2009,HTI,2368979837,630598280,-1738381557
9071,2009,HUN,71008750937,79289958409,8281207472
9072,2009,IDN,1.08E+11,1.31E+11,22036482795
9073,2009,IND,2.50E+11,1.81E+11,-69842347393
9074,2009,IOT,10984305,5776161,-5208144
9075,2009,IRL,67106259633,1.44E+11,76601076356
9076,2009,IRN,49820684163,62652690966,12832006803
9077,2009,IRQ,24339690417,36200686204,11860995787
9078,2009,ISL,3335364200,3698214001,362849801
9079,2009,ISR,47857745935,49880783146,2023037211
9080,2009,ITA,4.03E+11,3.99E+11,-3166393931
9081,2009,JAM,4477561427,1352555968,-3125005459
9082,2009,JOR,16330306867,6041952583,-10288354284
9083,2009,JPN,5.13E+11,6.32E+11,1.19E+11
9084,2009,KAZ,31390738905,39752554208,8361815303
9085,2009,KEN,11261764389,4685640522,-6576123867
9086,2009,KGZ,7610406770,1068385316,-6542021454
9087,2009,KHM,6238350735,6308976906,70626171
9088,2009,KIR,63315124,34200658,-29114466
9089,2009,KNA,215436833,80741852,-134694981
9090,2009,KOR,3.12E+11,3.76E+11,63795213895
9091,2009,KWT,16841954162,50279663895,33437709733
9092,2009,LAO,2613492130,1400037874,-1213454256
9093,2009,LBN,16177483371,3178789565,-12998693806
9094,2009,LBR,11735049446,1370081757,-10364967689
9095,2009,LBY,20485320877,36871528756,16386207879
9096,2009,LCA,2843542714,204930434,-2638612280
9097,2009,LKA,10298465694,7936835207,-2361630487
9098,2009,LSO,1552171515,458147799,-1094023716
9099,2009,LTU,18584249817,16632268594,-1951981223
9100,2009,LUX,23737631142,16021605181,-7716025961
9101,2009,LVA,14316168048,8590092264,-5726075784
9102,2009,MAC,5460906644,1175605046,-4285301598
9103,2009,MAR,31779474567,15676048963,-16103425604
9104,2009,MDA,3481260395,1499511097,-1981749298
9105,2009,MDG,2970075332,1243931296,-1726144036
9106,2009,MDV,812091046,114058099,-698032947
9107,2009,MEX,2.43E+11,2.33E+11,-10660431358
9108,2009,MHL,13422046422,748116068,-12673930354
9109,2009,MKD,4702889425,2965293375,-1737596050
9110,2009,MLI,2044122797,204096100,-1840026697
9111,2009,MLT,11462627077,4616526220,-6846100857
9112,2009,MMR,6397044333,5942281009,-454763324
9113,2009,MNE,2358360576,488641794,-1869718782
9114,2009,MNG,2428652383,1601808506,-826843877
9115,2009,MNP,70972366,5538930,-65433436
9116,2009,MOZ,4386587369,2489538285,-1897049084
9117,2009,MRT,1825329269,1823534076,-1795193
9118,2009,MSR,33236003,5556175,-27679828
9119,2009,MUS,3792566800,2002273713,-1790293087
9120,2009,MWI,1525545009,1290923343,-234621666
9121,2009,MYS,1.34E+11,1.88E+11,54938499936
9122,2009,MYT,436758582,10162005,-426596577
9123,2009,NAM,5986318104,3369055704,-2617262400
9124,2009,NCL,2065476259,980065684,-1085410575
9125,2009,NER,1464380035,424849633,-1039530402
9126,2009,NGA,39265314845,58444534627,19179219782
9127,2009,NIC,3806066830,2656025874,-1150040956
9128,2009,NIU,346452192,4837287,-341614905
9129,2009,NLD,4.41E+11,4.25E+11,-15940301086
9130,2009,NOR,74590081715,1.18E+11,43636699043
9131,2009,NPL,2639157282,732058039,-1907099243
9132,2009,NRU,104797611,22625271,-82172340
9133,2009,NZL,24916753913,25140412683,223658770
9134,2009,OMN,17674404931,27091135114,9416730183
9135,2009,PAK,33326517110,17857476485,-15469040625
9136,2009,PAN,44650790090,10271777879,-34379012211
9137,2009,PCN,3197569,3418702,221133
9138,2009,PER,21741045190,24026294588,2285249398
9139,2009,PHL,59158076676,56402065122,-2756011554
9140,2009,PLW,82621867,17659791,-64962076
9141,2009,PNG,3445891968,4190365381,744473413
9142,2009,POL,1.67E+11,1.32E+11,-34806742236
9143,2009,PRK,2852421019,1421332678,-1431088341
9144,2009,PRT,69248277531,42311252293,-26937025238
9145,2009,PRY,7850255199,4556509483,-3293745716
9146,2009,PSE,2932201450,530370580,-2401830870
9147,2009,PYF,1464454034,147055958,-1317398076
9148,2009,QAT,22006614574,43817147952,21810533378
9149,2009,ROU,51980712288,39062405675,-12918306613
9150,2009,RUS,1.73E+11,3.26E+11,1.54E+11
9151,2009,RWA,963151677,191763573,-771388104
9152,2009,SAU,87746119152,2.78E+11,1.90E+11
9153,2009,SDN,8995936816,7992509388,-1003427428
9154,2009,SEN,5111182024,1776518462,-3334663562
9155,2009,SGP,2.36E+11,2.67E+11,30632409003
9156,2009,SHN,53995460,22508356,-31487104
9157,2009,SLB,252746305,279733492,26987187
9158,2009,SLE,657323768,291069542,-366254226
9159,2009,SLV,6487716385,3899483324,-2588233061
9160,2009,SMR,327092447,138668831,-188423616
9161,2009,SOM,894330552,247352378,-646978174
9162,2009,SPM,67614956,9549122,-58065834
9163,2009,SRB,17179519584,8561503600,-8618015984
9164,2009,STP,128861065,17766313,-111094752
9165,2009,SUR,1456514434,1304094477,-152419957
9166,2009,SVK,55500233555,52623767422,-2876466133
9167,2009,SVN,24801823795,22226067082,-2575756713
9168,2009,SWE,1.18E+11,1.31E+11,12663386066
9169,2009,SWZ,242266582,875083868,632817286
9170,2009,SYC,615220072,374564279,-240655793
9171,2009,SYR,17939462179,10234142230,-7705319949
9172,2009,TCA,287952355,28301214,-259651141
9173,2009,TCD,925873295,2184542359,1258669064
9174,2009,TGO,3121629837,1125007025,-1996622812
9175,2009,THA,1.23E+11,1.63E+11,40004029624
9176,2009,TJK,2584134048,807115039,-1777019009
9177,2009,TKL,101706622,36926291,-64780331
9178,2009,TKM,5332335990,2093416333,-3238919657
9179,2009,TLS,367479710,99208549,-268271161
9180,2009,TON,125414165,14544911,-110869254
9181,2009,TTO,6894732104,12581851618,5687119514
9182,2009,TUN,19703225100,15516371281,-4186853819
9183,2009,TUR,1.37E+11,1.02E+11,-35104140206
9184,2009,TUV,106203114,4334827,-101868287
9185,2009,TWN,2.88E+11,2.53E+11,-34599844963
9186,2009,TZA,6775633932,2797228995,-3978404937
9187,2009,UGA,4001547117,1688362723,-2313184394
9188,2009,UKR,49752574708,46743027554,-3009547154
9189,2009,URY,7424488028,6475888452,-948599576
9190,2009,USA,1.55E+12,1.06E+12,-4.90E+11
9191,2009,UZB,8096795354,4532770553,-3564024801
9192,2009,VAT,32187555,15546554,-16641001
9193,2009,VCT,588190247,255685531,-332504716
9194,2009,VEN,38401752146,48677936136,10276183990
9195,2009,VGB,3019823770,317836485,-2701987285
9196,2009,VNM,73449394327,61785589915,-11663804412
9197,2009,VUT,389089547,188013165,-201076382
9198,2009,WLF,23459292,722691,-22736601
9199,2009,WSM,263321713,75501546,-187820167
9200,2009,YEM,9669910411,5642017711,-4027892700
9201,2009,ZAF,65054641540,80832807481,15778165941
9202,2009,ZMB,3635890289,5750217648,2114327359
9203,2009,ZWE,2798956162,1480343528,-1318612634
9204,2010,ABW,1280681664,376564090,-904117574
9205,2010,AGO,18251053802,51157963833,32906910031
9206,2010,AIA,62269883,12982672,-49287211
9207,2010,ALB,4423844582,1780337749,-2643506833
9208,2010,AND,1783911773,257754884,-1526156889
9209,2010,ANT,2932842212,1733976034,-1198866178
9210,2010,ARE,1.65E+11,1.90E+11,25263231834
9211,2010,ARG,54941042290,68595839042,13654796752
9212,2010,ARM,2886344522,961117280,-1925227242
9213,2010,ASM,87927142,36866475,-51060667
9214,2010,ATA,227657085,3741176,-223915909
9215,2010,ATG,2596499150,168205120,-2428294030
9216,2010,AUS,1.84E+11,2.02E+11,18488418952
9217,2010,AUT,1.60E+11,1.43E+11,-17501438553
9218,2010,AZE,10340966027,24247781430,13906815403
9219,2010,BDI,444809271,78593103,-366216168
9220,2010,BEL,3.78E+11,3.97E+11,19386597232
9221,2010,BEN,6658330954,1207324944,-5451006010
9222,2010,BFA,1715841640,520596215,-1195245425
9223,2010,BGD,31563243322,20795215095,-10768028227
9224,2010,BGR,25072801633,20350441403,-4722360230
9225,2010,BHR,12414748430,9129820322,-3284928108
9226,2010,BHS,11093300966,3024304039,-8068996927
9227,2010,BIH,7864122987,4409398546,-3454724441
9228,2010,BLR,32415599644,21735758281,-10679841363
9229,2010,BLZ,758683966,407424987,-351258979
9230,2010,BMU,4600857655,739209549,-3861648106
9231,2010,BOL,6045501804,6598080841,552579037
9232,2010,BRA,1.90E+11,2.15E+11,25093022907
9233,2010,BRB,2658567948,1144513738,-1514054210
9234,2010,BRN,2923798765,8529885035,5606086270
9235,2010,BTN,292933291,204668011,-88265280
9236,2010,BWA,7184369179,3320503518,-3863865661
9237,2010,CAF,446055358,131409921,-314645437
9238,2010,CAN,4.24E+11,3.88E+11,-35449873790
9239,2010,CCK,12770938,9272131,-3498807
9240,2010,CHE,2.20E+11,2.22E+11,2508275408
9241,2010,CHL,53686435800,72428852819,18742417019
9242,2010,CHN,1.20E+12,1.80E+12,5.95E+11
9243,2010,CIV,7749935110,11785333024,4035397914
9244,2010,CMR,5045014112,4774474445,-270539667
9245,2010,COD,4345447425,5497791665,1152344240
9246,2010,COG,4119058793,10559513691,6440454898
9247,2010,COK,96538051,23839892,-72698159
9248,2010,COL,41588037505,41045186930,-542850575
9249,2010,COM,263016932,35431360,-227585572
9250,2010,CPV,909962166,123062219,-786899947
9251,2010,CRI,13164266814,25618234085,12453967271
9252,2010,CUB,5673881171,2661008157,-3012873014
9253,2010,CXR,56005140,16686038,-39319102
9254,2010,CYM,4966476285,1104800565,-3861675720
9255,2010,CYP,14917941451,3629397387,-11288544064
9256,2010,CZE,1.33E+11,1.28E+11,-4605222758
9257,2010,DEU,1.05E+12,1.26E+12,2.09E+11
9258,2010,DJI,2139148733,74249798,-2064898935
9259,2010,DMA,291173724,61520239,-229653485
9260,2010,DNK,82461687509,88749728277,6288040768
9261,2010,DOM,16157144684,6615482909,-9541661775
9262,2010,DZA,41753431342,57697285241,15943853899
9263,2010,ECU,20016946792,20937817198,920870406
9264,2010,EGY,62061588069,29301627534,-32759960535
9265,2010,ERI,474289347,17618811,-456670536
9266,2010,ESH,941504,1025219,83715
9267,2010,ESP,3.28E+11,2.41E+11,-87480224224
9268,2010,EST,14254196409,12836359943,-1417836466
9269,2010,ETH,8528365218,2374249223,-6154115995
9270,2010,FIN,75123486156,70358799672,-4764686484
9271,2010,FJI,1567088682,773588505,-793500177
9272,2010,FLK,112659234,171487434,58828200
9273,2010,FRA,6.49E+11,5.14E+11,-1.35E+11
9274,2010,FRO,772783113,781291617,8508504
9275,2010,FSM,130795647,54935285,-75860362
9276,2010,GAB,2497745043,6876908014,4379162971
9277,2010,GBR,5.97E+11,4.17E+11,-1.80E+11
9278,2010,GEO,5588833381,2540401628,-3048431753
9279,2010,GHA,11061877169,4695135521,-6366741648
9280,2010,GIB,9875462624,360320327,-9515142297
9281,2010,GIN,2091607736,2009213980,-82393756
9282,2010,GMB,774834592,70660301,-704174291
9283,2010,GNB,229592113,164569607,-65022506
9284,2010,GNQ,5090859849,9109593958,4018734109
9285,2010,GRC,67226461904,26902780526,-40323681378
9286,2010,GRD,194707691,33123653,-161584038
9287,2010,GRL,884935449,630587283,-254348166
9288,2010,GTM,12876851934,8778923138,-4097928796
9289,2010,GUM,962604855,82158043,-880446812
9290,2010,GUY,1543233866,919456859,-623777007
9291,2010,HKG,4.85E+11,1.19E+11,-3.66E+11
9292,2010,HND,9343556748,6476241287,-2867315461
9293,2010,HRV,21277603678,11845321496,-9432282182
9294,2010,HTI,3430129912,662585592,-2767544320
9295,2010,HUN,82750154544,92526499547,9776345003
9296,2010,IDN,1.48E+11,1.67E+11,18735280632
9297,2010,IND,3.39E+11,2.35E+11,-1.04E+11
9298,2010,IOT,5800012,4303799,-1496213
9299,2010,IRL,67179940028,1.46E+11,79288926721
9300,2010,IRN,72043144451,1.28E+11,55574738486
9301,2010,IRQ,31715807017,47093933113,15378126096
9302,2010,ISL,4443100489,4309996428,-133104061
9303,2010,ISR,60206661848,61247397164,1040735316
9304,2010,ITA,4.73E+11,4.40E+11,-33212384176
9305,2010,JAM,4973176165,1134240113,-3838936052
9306,2010,JOR,17966610930,6514008700,-11452602230
9307,2010,JPN,6.45E+11,8.07E+11,1.63E+11
9308,2010,KAZ,34309427270,52436112115,18126684845
9309,2010,KEN,13600624692,5203924964,-8396699728
9310,2010,KGZ,6592664040,1368067319,-5224596721
9311,2010,KHM,9221581586,7233062015,-1988519571
9312,2010,KIR,104605507,23344530,-81260977
9313,2010,KNA,292904119,78802885,-214101234
9314,2010,KOR,4.10E+11,4.83E+11,72485455322
9315,2010,KWT,23162248491,66087056919,42924808428
9316,2010,LAO,3264683703,2056308664,-1208375039
9317,2010,LBN,18202843393,3703673328,-14499170065
9318,2010,LBR,16573838171,1010492045,-15563346126
9319,2010,LBY,21418376327,47404469470,25986093143
9320,2010,LCA,3534639866,96265673,-3438374193
9321,2010,LKA,14576243008,8871428713,-5704814295
9322,2010,LSO,1589537740,773906679,-815631061
9323,2010,LTU,24087251200,20748993582,-3338257618
9324,2010,LUX,25532987174,17063223924,-8469763250
9325,2010,LVA,17764484523,9959009354,-7805475169
9326,2010,MAC,6333542912,977034790,-5356508122
9327,2010,MAR,34669032381,19427835902,-15241196479
9328,2010,MDA,3978703838,1787231880,-2191471958
9329,2010,MDG,2429300047,1226439831,-1202860216
9330,2010,MDV,947064172,138080316,-808983856
9331,2010,MEX,3.11E+11,3.01E+11,-10221923699
9332,2010,MHL,10919521414,428518013,-10491003401
9333,2010,MKD,5069737006,3673458756,-1396278250
9334,2010,MLI,2965347345,799185014,-2166162331
9335,2010,MLT,13569983065,6047647647,-7522335418
9336,2010,MMR,9113302452,6904908328,-2208394124
9337,2010,MNE,2317444203,453069756,-1864374447
9338,2010,MNG,3494183980,2963717560,-530466420
9339,2010,MNP,88602576,4248530,-84354046
9340,2010,MOZ,5184652672,3383659567,-1800993105
9341,2010,MRT,2238609335,2395049092,156439757
9342,2010,MSR,9880986,4998940,-4882046
9343,2010,MUS,4470992786,2154615235,-2316377551
9344,2010,MWI,1432123159,1264946815,-167176344
9345,2010,MYS,1.80E+11,2.55E+11,75266721531
9346,2010,MYT,352395363,8671493,-343723870
9347,2010,NAM,5529133152,5239281555,-289851597
9348,2010,NCL,2946219412,1440688987,-1505530425
9349,2010,NER,1408202400,324661320,-1083541080
9350,2010,NGA,42379601596,87033103803,44653502207
9351,2010,NIC,4651757742,3356502782,-1295254960
9352,2010,NIU,102931770,60491057,-42440713
9353,2010,NLD,5.26E+11,4.95E+11,-31155237817
9354,2010,NOR,84140714913,1.34E+11,50347179022
9355,2010,NPL,3400464823,847810625,-2552654198
9356,2010,NRU,26167469,56646023,30478554
9357,2010,NZL,30304292996,31020275463,715982467
9358,2010,OMN,20623082245,35575471316,14952389071
9359,2010,PAK,40577927371,21234471973,-19343455398
9360,2010,PAN,56988166215,11443293596,-45544872619
9361,2010,PCN,2246653,1958914,-287739
9362,2010,PER,30450289765,32707239569,2256949804
9363,2010,PHL,80062235484,71262753580,-8799481904
9364,2010,PLW,89036402,17155315,-71881087
9365,2010,PNG,4601521893,5251184235,649662342
9366,2010,POL,1.96E+11,1.53E+11,-42204509604
9367,2010,PRK,3355384262,2072549771,-1282834491
9368,2010,PRT,75315368208,47718697517,-27596670691
9369,2010,PRY,11617465787,6599249745,-5018216042
9370,2010,PSE,3186846507,606959319,-2579887188
9371,2010,PYF,1541196791,186503306,-1354693485
9372,2010,QAT,23129411153,72162472880,49033061727
9373,2010,ROU,59506202991,48422952162,-11083250829
9374,2010,RUS,2.35E+11,4.42E+11,2.07E+11
9375,2010,RWA,1081483072,190548100,-890934972
9376,2010,SAU,1.03E+11,3.64E+11,2.61E+11
9377,2010,SDN,11166624021,10754171924,-412452097
9378,2010,SEN,6042085220,2047791488,-3994293732
9379,2010,SGP,2.93E+11,3.53E+11,59576643964
9380,2010,SHN,54366874,20361971,-34004903
9381,2010,SLB,340157102,393144162,52987060
9382,2010,SLE,801900995,344230458,-457670537
9383,2010,SLV,7675749507,4670256170,-3005493337
9384,2010,SMR,355313146,173312518,-182000628
9385,2010,SOM,1049008627,353882123,-695126504
9386,2010,SPM,60116699,6656767,-53459932
9387,2010,SRB,16790308834,10003666717,-6786642117
9388,2010,STP,135162405,19243260,-115919145
9389,2010,SUR,1564797333,1798443938,233646605
9390,2010,SVK,67182118219,62384592747,-4797525472
9391,2010,SVN,27630636200,24709563423,-2921072777
9392,2010,SWE,1.45E+11,1.53E+11,7726111953
9393,2010,SWZ,2093762294,1887113754,-206648540
9394,2010,SYC,632703103,395170143,-237532960
9395,2010,SYR,19849760175,11576912634,-8272847541
9396,2010,TCA,224503155,26360225,-198142930
9397,2010,TCD,1322924857,2957954325,1635029468
9398,2010,TGO,3568254954,1049509285,-2518745669
9399,2010,THA,1.69E+11,2.08E+11,39467846755
9400,2010,TJK,3161245474,1076616324,-2084629150
9401,2010,TKL,40217812,30433397,-9784415
9402,2010,TKM,4751743716,2442131858,-2309611858
9403,2010,TLS,373507728,68569953,-304937775
9404,2010,TON,176873521,12162285,-164711236
9405,2010,TTO,6841710416,15635108492,8793398076
9406,2010,TUN,22921889721,17467702370,-5454187351
9407,2010,TUR,1.78E+11,1.15E+11,-63616335950
9408,2010,TUV,74878347,14639580,-60238767
9409,2010,TWN,4.33E+11,3.35E+11,-98059379293
9410,2010,TZA,8681129614,3830470304,-4850659310
9411,2010,UGA,4464919975,1777441300,-2687478675
9412,2010,UKR,65094219195,58254128458,-6840090737
9413,2010,URY,9999224461,7978315297,-2020909164
9414,2010,USA,1.87E+12,1.27E+12,-5.98E+11
9415,2010,UZB,8295826047,5296553966,-2999272081
9416,2010,VAT,73385557,5324513,-68061044
9417,2010,VCT,573910650,157139186,-416771464
9418,2010,VEN,37600004906,59621136801,22021131895
9419,2010,VGB,4023156231,502919180,-3520237051
9420,2010,VNM,93002623285,77337297911,-15665325374
9421,2010,VUT,969194527,482684477,-486510050
9422,2010,WLF,37067000,2142472,-34924528
9423,2010,WSM,358229964,86916775,-271313189
9424,2010,YEM,9858118681,8645666846,-1212451835
9425,2010,ZAF,87345742596,99854962587,12509219991
9426,2010,ZMB,5105307694,9512464185,4407156491
9427,2010,ZWE,5077112090,3300151339,-1776960751
9428,2011,ABW,3100129545,4397691409,1297561864
9429,2011,AGO,21813049200,63845170646,42032121446
9430,2011,AIA,60556548,18176369,-42380179
9431,2011,ALB,5033364273,2136046363,-2897317910
9432,2011,AND,1657918790,89837577,-1568081213
9433,2011,ANT,4644241,284014,-4360227
9434,2011,ARE,2.01E+11,2.51E+11,50740292632
9435,2011,ARG,70621676689,81828298469,11206621780
9436,2011,ARM,3175104792,1406853906,-1768250886
9437,2011,ASM,230052872,52546284,-177506588
9438,2011,ATA,55708321,14040054,-41668267
9439,2011,ATG,3498441221,282464027,-3215977194
9440,2011,AUS,2.20E+11,2.58E+11,38496824891
9441,2011,AUT,1.88E+11,1.67E+11,-20791800790
9442,2011,AZE,12988740355,32642552217,19653811862
9443,2011,BDI,612662188,140648091,-472014097
9444,2011,BEL,4.45E+11,4.65E+11,19838038990
9445,2011,BEN,9856294363,1473010722,-8383283641
9446,2011,BFA,2609597670,643242102,-1966355568
9447,2011,BGD,38178878946,26082522849,-12096356097
9448,2011,BGR,32647301200,27595015772,-5052285428
9449,2011,BHR,18478687079,11100467700,-7378219379
9450,2011,BHS,11804978890,3008207907,-8796770983
9451,2011,BIH,9443327362,5454278461,-3989048901
9452,2011,BLR,41525833626,42091615603,565781977
9453,2011,BLZ,3896736063,853450262,-3043285801
9454,2011,BMU,3747966707,617252238,-3130714469
9455,2011,BOL,8669953479,8855077944,185124465
9456,2011,BRA,2.35E+11,2.67E+11,32090229104
9457,2011,BRB,6084470591,1182857375,-4901613216
9458,2011,BRN,5802236593,11844311806,6042075213
9459,2011,BTN,375625672,261325279,-114300393
9460,2011,BWA,5947309649,5828692328,-118617321
9461,2011,CAF,716979891,145110980,-571868911
9462,2011,CAN,4.79E+11,4.50E+11,-28887047503
9463,2011,CCK,16378366,52042269,35663903
9464,2011,CHE,2.78E+11,2.80E+11,1661595536
9465,2011,CHL,68633804455,84778154578,16144350123
9466,2011,CHN,1.55E+12,2.12E+12,5.65E+11
9467,2011,CIV,7639500867,12223921903,4584421036
9468,2011,CMR,5823765259,5153402913,-670362346
9469,2011,COD,5656921144,6966100312,1309179168
9470,2011,COG,6780143492,11159391768,4379248276
9471,2011,COK,123636871,33064966,-90571905
9472,2011,COL,54483704438,59782596348,5298891910
9473,2011,COM,191130063,61235514,-129894549
9474,2011,CPV,1150519217,76595416,-1073923801
9475,2011,CRI,16375595699,30038969645,13663373946
9476,2011,CUB,6400187282,3439093808,-2961093474
9477,2011,CUW,4305005940,3454336144,-850669796
9478,2011,CXR,61780865,22029238,-39751627
9479,2011,CYM,3325104192,942982247,-2382121945
9480,2011,CYP,15974895629,5086433544,-10888462085
9481,2011,CZE,1.59E+11,1.58E+11,-962801910
9482,2011,DEU,1.24E+12,1.47E+12,2.26E+11
9483,2011,DJI,2626572313,104129953,-2522442360
9484,2011,DMA,282771987,88769295,-194002692
9485,2011,DNK,95551586543,1.04E+11,8205185743
9486,2011,DOM,18102691869,7904292042,-10198399827
9487,2011,DZA,51774964404,73384535653,21609571249
9488,2011,ECU,24001668761,25198854936,1197186175
9489,2011,EGY,66900096384,36646045348,-30254051036
9490,2011,ERI,548957551,181877984,-367079567
9491,2011,ESH,1502185,4060227,2558042
9492,2011,ESP,3.64E+11,2.89E+11,-75556120770
9493,2011,EST,20655015888,18674390157,-1980625731
9494,2011,ETH,9124729066,2746560965,-6378168101
9495,2011,FIN,90066463000,79646131641,-10420331359
9496,2011,FJI,1966040525,918023923,-1048016602
9497,2011,FLK,192153332,178901539,-13251793
9498,2011,FRA,7.68E+11,5.88E+11,-1.81E+11
9499,2011,FRO,806031358,1033687541,227656183
9500,2011,FSM,158320012,49683924,-108636088
9501,2011,GAB,3273812935,11403388832,8129575897
9502,2011,GBR,6.83E+11,5.05E+11,-1.78E+11
9503,2011,GEO,7885180151,3544681335,-4340498816
9504,2011,GHA,15421522203,13744812266,-1676709937
9505,2011,GIB,16014459164,363205121,-15651254043
9506,2011,GIN,3117353998,1954793857,-1162560141
9507,2011,GMB,1050872273,170627595,-880244678
9508,2011,GNB,314178998,366178008,51999010
9509,2011,GNQ,3335650202,12635478944,9299828742
9510,2011,GRC,68376539031,31814456298,-36562082733
9511,2011,GRD,215767001,41794230,-173972771
9512,2011,GRL,971287203,687371190,-283916013
9513,2011,GTM,15993551354,11014871924,-4978679430
9514,2011,GUM,1110243581,113835571,-996408010
9515,2011,GUY,1967420180,1081887995,-885532185
9516,2011,HKG,5.76E+11,2.01E+11,-3.76E+11
9517,2011,HND,11820209044,7984240003,-3835969041
9518,2011,HRV,24103112785,13424422705,-10678690080
9519,2011,HTI,3656497292,866468241,-2790029051
9520,2011,HUN,97060693099,1.09E+11,11677058294
9521,2011,IDN,1.93E+11,2.16E+11,23363852707
9522,2011,IND,4.26E+11,3.05E+11,-1.21E+11
9523,2011,IOT,59545123,13950112,-45595011
9524,2011,IRL,70321864401,1.55E+11,85128293001
9525,2011,IRN,78890667182,1.81E+11,1.03E+11
9526,2011,IRQ,34974965772,73703803066,38728837294
9527,2011,ISL,5884188896,5001761076,-882427820
9528,2011,ISR,74667847522,71020319988,-3647527534
9529,2011,ITA,5.33E+11,5.13E+11,-19899823573
9530,2011,JAM,6255809679,1587613082,-4668196597
9531,2011,JOR,21587776296,7713018951,-13874757345
9532,2011,JPN,7.94E+11,8.67E+11,72378664180
9533,2011,KAZ,42647539402,81109921917,38462382515
9534,2011,KEN,13075466399,5053653178,-8021813221
9535,2011,KGZ,8268501340,808846800,-7459654540
9536,2011,KHM,11818740123,9090318117,-2728422006
9537,2011,KIR,155805072,53091468,-102713604
9538,2011,KNA,261056625,87394969,-173661656
9539,2011,KOR,5.05E+11,5.68E+11,62870874378
9540,2011,KWT,24866248212,92744415108,67878166896
9541,2011,LAO,4240187965,2988480574,-1251707391
9542,2011,LBN,19891839011,4600887577,-15290951434
9543,2011,LBR,18507522685,1063034769,-17444487916
9544,2011,LBY,7236116842,18128675515,10892558673
9545,2011,LCA,3669541185,192754192,-3476786993
9546,2011,LKA,19750204593,10812840991,-8937363602
9547,2011,LSO,1830514794,1021816910,-808697884
9548,2011,LTU,33188155754,28407299929,-4780855825
9549,2011,LUX,30078682410,19837668547,-10241013863
9550,2011,LVA,25539425326,13576689341,-11962735985
9551,2011,MAC,8160070489,1237478558,-6922591931
9552,2011,MAR,43160402833,23636086471,-19524316362
9553,2011,MDA,5097884605,2558612360,-2539272245
9554,2011,MDG,2913989838,1466618166,-1447371672
9555,2011,MDV,1112485805,202493901,-909991904
9556,2011,MEX,3.66E+11,3.65E+11,-695030637
9557,2011,MHL,14119061741,484055113,-13635006628
9558,2011,MKD,6402455893,5029057246,-1373398647
9559,2011,MLI,3617351644,1210283476,-2407068168
9560,2011,MLT,17680139201,6030021547,-11650117654
9561,2011,MMR,12674642403,8835528452,-3839113951
9562,2011,MNE,2522351247,595117052,-1927234195
9563,2011,MNG,6435765272,4233516687,-2202248585
9564,2011,MNP,88921453,3359073,-85562380
9565,2011,MOZ,7471590672,4456396502,-3015194170
9566,2011,MRT,2946980586,3480516114,533535528
9567,2011,MSR,15608312,3283616,-12324696
9568,2011,MUS,5431918288,2439276274,-2992642014
9569,2011,MWI,1781125693,1474235618,-306890075
9570,2011,MYS,2.04E+11,2.92E+11,87639233235
9571,2011,MYT,386070701,15288006,-370782695
9572,2011,NAM,6427922710,5848017644,-579905066
9573,2011,NCL,3114731167,1725397875,-1389333292
9574,2011,NER,1399217578,770129805,-629087773
9575,2011,NGA,53296720435,1.28E+11,74311060315
9576,2011,NIC,5628291229,4675210409,-953080820
9577,2011,NIU,1525554501,3935558,-1521618943
9578,2011,NLD,6.45E+11,5.60E+11,-84589322534
9579,2011,NOR,97919578174,1.63E+11,65511524745
9580,2011,NPL,4826641482,859844510,-3966796972
9581,2011,NRU,39022677,72153486,33130809
9582,2011,NZL,36343799690,37566347891,1222548201
9583,2011,OMN,24744255776,46519900153,21775644377
9584,2011,PAK,46968761260,25515165070,-21453596190
9585,2011,PAN,65067494324,12967929702,-52099564622
9586,2011,PCN,3624353,3321203,-303150
9587,2011,PER,36971235603,43192643895,6221408292
9588,2011,PHL,89783416272,73234174538,-16549241734
9589,2011,PLW,104974378,18750799,-86223579
9590,2011,PNG,6639482973,7326065440,686582467
9591,2011,POL,2.36E+11,1.86E+11,-50323620376
9592,2011,PRK,3808006241,3130231850,-677774391
9593,2011,PRT,80495550805,58986359554,-21509191251
9594,2011,PRY,13561383629,8308218541,-5253165088
9595,2011,PSE,3729211432,746785652,-2982425780
9596,2011,PYF,1739978823,229426850,-1510551973
9597,2011,QAT,19477538981,1.04E+11,84809959771
9598,2011,ROU,73698401739,61660100855,-12038300884
9599,2011,RUS,3.14E+11,5.59E+11,2.46E+11
9600,2011,RWA,1272946050,326605163,-946340887
9601,2011,SAU,1.26E+11,5.27E+11,4.00E+11
9602,2011,SDN,10566539908,14667406600,4100866692
9603,2011,SEN,8089591055,2883744844,-5205846211
9604,2011,SGP,3.54E+11,3.99E+11,45391919396
9605,2011,SHN,50485758,23390432,-27095326
9606,2011,SLB,430205771,562847951,132642180
9607,2011,SLE,1471949545,479464375,-992485170
9608,2011,SLV,9686583179,5723341195,-3963241984
9609,2011,SMR,383464725,157014975,-226449750
9610,2011,SOM,1369192872,413332326,-955860546
9611,2011,SPM,60632989,13869828,-46763161
9612,2011,SRB,20413866725,12238091310,-8175775415
9613,2011,STP,170155676,18463772,-151691904
9614,2011,SUR,1809680193,2242526549,432846356
9615,2011,SVK,81132936130,75682316922,-5450619208
9616,2011,SVN,33316866477,29363119463,-3953747014
9617,2011,SWE,1.71E+11,1.81E+11,9585383866
9618,2011,SWZ,1917772171,1746725397,-171046774
9619,2011,SXM,433466571,24466929,-408999642
9620,2011,SYC,627972653,381690839,-246281814
9621,2011,SYR,18067422362,7734431481,-10332990881
9622,2011,TCA,274285417,41297157,-232988260
9623,2011,TCD,792941309,3740851463,2947910154
9624,2011,TGO,5668779220,1714732281,-3954046939
9625,2011,THA,2.07E+11,2.43E+11,35699339619
9626,2011,TJK,4079833459,944453464,-3135379995
9627,2011,TKL,33277155,41729171,8452016
9628,2011,TKM,6702924991,6734789994,31865003
9629,2011,TLS,604827154,146082105,-458745049
9630,2011,TON,170699389,17544029,-153155360
9631,2011,TTO,9335632232,20189560807,10853928575
9632,2011,TUN,24651129809,18565143497,-6085986312
9633,2011,TUR,2.30E+11,1.35E+11,-94880411046
9634,2011,TUV,73571181,12600090,-60971091
9635,2011,TWN,5.64E+11,3.70E+11,-1.94E+11
9636,2011,TZA,11976689591,4920705718,-7055983873
9637,2011,UGA,5643273074,2310621194,-3332651880
9638,2011,UKR,87998326494,75903718544,-12094607950
9639,2011,URY,12542736150,9312483232,-3230252918
9640,2011,USA,2.16E+12,1.49E+12,-6.66E+11
9641,2011,UZB,9649513595,5958602854,-3690910741
9642,2011,VAT,78500039,61694029,-16806010
9643,2011,VCT,589006348,108603255,-480403093
9644,2011,VEN,54697321753,77537160208,22839838455
9645,2011,VGB,4211599550,601094007,-3610505543
9646,2011,VNM,1.19E+11,1.02E+11,-16829689417
9647,2011,VUT,513411483,700312510,186901027
9648,2011,WLF,41214532,408128,-40806404
9649,2011,WSM,378836019,62428716,-316407303
9650,2011,YEM,9902009520,9710735749,-191273771
9651,2011,ZAF,1.11E+11,1.36E+11,24621982131
9652,2011,ZMB,6771851444,12072423162,5300571718
9653,2011,ZWE,7937101720,2618135208,-5318966512
9654,2012,ABW,2380052552,1813524955,-566527597
9655,2012,AGO,26859755405,73030752966,46170997561
9656,2012,AIA,51815499,10422627,-41392872
9657,2012,ALB,4834748850,2102642366,-2732106484
9658,2012,AND,1517884664,270592817,-1247291847
9659,2012,ARE,2.35E+11,3.56E+11,1.21E+11
9660,2012,ARG,66481298047,80096721754,13615423707
9661,2012,ARM,3498212494,1434112429,-2064100065
9662,2012,ASM,235863507,89921027,-145942480
9663,2012,ATA,31333712,10775789,-20557923
9664,2012,ATG,2497882428,623651699,-1874230729
9665,2012,AUS,2.31E+11,2.47E+11,16202577729
9666,2012,AUT,1.76E+11,1.57E+11,-19258372532
9667,2012,AZE,15293987603,30113736621,14819749018
9668,2012,BDI,514939371,181708888,-333230483
9669,2012,BEL,4.20E+11,4.35E+11,14500205416
9670,2012,BEN,6536701296,1296215170,-5240486126
9671,2012,BFA,2709080619,1288318342,-1420762277
9672,2012,BGD,37023092357,26794662831,-10228429526
9673,2012,BGR,32907886198,26863148610,-6044737588
9674,2012,BHR,13529922034,13449246829,-80675205
9675,2012,BHS,11287724734,2858258724,-8429466010
9676,2012,BIH,8717117761,4779264386,-3937853375
9677,2012,BLR,38540002905,44012021487,5472018582
9678,2012,BLZ,1454301646,519149372,-935152274
9679,2012,BMU,2981052840,291259964,-2689792876
9680,2012,BOL,8901316663,11096880563,2195563900
9681,2012,BRA,2.39E+11,2.58E+11,18237115204
9682,2012,BRB,5211601374,697662484,-4513938890
9683,2012,BRN,5344273687,12674350481,7330076794
9684,2012,BTN,321690806,194920113,-126770693
9685,2012,BWA,6461484061,5646724234,-814759827
9686,2012,CAF,353435648,166092532,-187343116
9687,2012,CAN,4.94E+11,4.56E+11,-38048707015
9688,2012,CCK,20412395,6723922,-13688473
9689,2012,CHE,2.56E+11,2.85E+11,29272212402
9690,2012,CHL,74492915901,80387496381,5894580480
9691,2012,CHN,1.62E+12,2.25E+12,6.31E+11
9692,2012,CIV,9980637631,11882189937,1901552306
9693,2012,CMR,7075519958,5396710683,-1678809275
9694,2012,COD,6017596106,6798771787,781175681
9695,2012,COG,7081007086,11677878147,4596871061
9696,2012,COK,138366134,48835119,-89531015
9697,2012,COL,56575540589,65306594657,8731054068
9698,2012,COM,248390416,57948414,-190442002
9699,2012,CPV,862212727,86910002,-775302725
9700,2012,CRI,16171816079,35502210715,19330394636
9701,2012,CUB,6422456426,2959041726,-3463414700
9702,2012,CUW,4604663397,3789745884,-814917513
9703,2012,CXR,59140961,37974799,-21166162
9704,2012,CYM,2082231319,594708619,-1487522700
9705,2012,CYP,15400304155,5559271385,-9841032770
9706,2012,CZE,1.47E+11,1.53E+11,6022005700
9707,2012,DEU,1.17E+12,1.39E+12,2.26E+11
9708,2012,DJI,3307431030,110144637,-3197286393
9709,2012,DMA,271644894,89291856,-182353038
9710,2012,DNK,90328748600,96767261320,6438512720
9711,2012,DOM,17659330853,8645473467,-9013857386
9712,2012,DZA,53540416305,72818615707,19278199402
9713,2012,ECU,24739706826,26860342268,2120635442
9714,2012,EGY,73603457995,34304009211,-39299448784
9715,2012,ERI,565474268,305121242,-260353026
9716,2012,ESH,3637564,1077085,-2560479
9717,2012,ESP,3.27E+11,2.74E+11,-52815058362
9718,2012,EST,23279554348,17789591395,-5489962953
9719,2012,ETH,12117487893,2919324025,-9198163868
9720,2012,FIN,83268545173,74071589487,-9196955686
9721,2012,FJI,2070015486,980140023,-1089875463
9722,2012,FLK,136809044,199996749,63187705
9723,2012,FRA,7.07E+11,5.59E+11,-1.48E+11
9724,2012,FRO,980862654,965629221,-15233433
9725,2012,FSM,186225667,78641142,-107584525
9726,2012,GAB,3593950154,10982654954,7388704800
9727,2012,GBR,6.72E+11,4.73E+11,-2.00E+11
9728,2012,GEO,9002500715,3174556559,-5827944156
9729,2012,GHA,19628609232,12546291326,-7082317906
9730,2012,GIB,18659676342,481713827,-18177962515
9731,2012,GIN,3383676573,1756666507,-1627010066
9732,2012,GMB,955485074,159089113,-796395961
9733,2012,GNB,298707430,169888795,-128818635
9734,2012,GNQ,2344244322,14854236839,12509992517
9735,2012,GRC,63193747819,32779106647,-30414641172
9736,2012,GRD,212069269,47438719,-164630550
9737,2012,GRL,845413661,694261643,-151152018
9738,2012,GTM,15883623132,10775271573,-5108351559
9739,2012,GUM,1203169381,149107586,-1054061795
9740,2012,GUY,1908296451,1260244568,-648051883
9741,2012,HKG,6.43E+11,2.22E+11,-4.21E+11
9742,2012,HND,11789760172,8264319767,-3525440405
9743,2012,HRV,21493596821,12059582233,-9434014588
9744,2012,HTI,3275980267,921477740,-2354502527
9745,2012,HUN,92628606822,1.01E+11,8191595680
9746,2012,IDN,2.11E+11,2.10E+11,-709612068
9747,2012,IND,4.48E+11,2.98E+11,-1.50E+11
9748,2012,IOT,111295669,30446074,-80849595
9749,2012,IRL,71875649189,1.43E+11,71202032854
9750,2012,IRN,66276879730,83714267870,17437388140
9751,2012,IRQ,44433200672,88993505791,44560305119
9752,2012,ISL,4976953049,5128126354,151173305
9753,2012,ISR,74646164842,68270855482,-6375309360
9754,2012,ITA,4.68E+11,4.95E+11,27189392476
9755,2012,JAM,6393256380,1512594933,-4880661447
9756,2012,JOR,24556284745,7867922168,-16688362577
9757,2012,JPN,8.22E+11,8.53E+11,31117230037
9758,2012,KAZ,47159615278,81673267309,34513652031
9759,2012,KEN,16548187023,5426598126,-11121588897
9760,2012,KGZ,9294565094,1230683209,-8063881885
9761,2012,KHM,14048841472,9337465441,-4711376031
9762,2012,KIR,158916830,63171137,-95745693
9763,2012,KNA,268009016,89338782,-178670234
9764,2012,KOR,5.11E+11,5.62E+11,51305058690
9765,2012,KWT,25778040503,1.11E+11,85094031830
9766,2012,LAO,5800132040,3181449042,-2618682998
9767,2012,LBN,23084652436,4438739597,-18645912839
9768,2012,LBR,16155331000,1177367624,-14977963376
9769,2012,LBY,21975215193,55865196913,33889981720
9770,2012,LCA,2039167513,99965798,-1939201715
9771,2012,LKA,18229432493,10197167039,-8032265454
9772,2012,LSO,1872836613,903978236,-968858377
9773,2012,LTU,34343626983,31549060302,-2794566681
9774,2012,LUX,27450609926,17378331055,-10072278871
9775,2012,LVA,28175900278,13686056765,-14489843513
9776,2012,MAC,9104779691,1393583450,-7711196241
9777,2012,MAR,43987112412,23643350368,-20343762044
9778,2012,MDA,5158487172,2554552195,-2603934977
9779,2012,MDG,3063071161,1712490152,-1350581009
9780,2012,MDV,1089048494,221695137,-867353357
9781,2012,MEX,3.91E+11,3.83E+11,-7886396713
9782,2012,MHL,11088253939,956276692,-10131977247
9783,2012,MKD,6017833860,4451593899,-1566239961
9784,2012,MLI,3479150675,1826470037,-1652680638
9785,2012,MLT,17197960724,6152660152,-11045300572
9786,2012,MMR,15629100196,8939529384,-6689570812
9787,2012,MNE,2458011135,651341504,-1806669631
9788,2012,MNG,7175484767,4386113544,-2789371223
9789,2012,MNP,85705056,4054970,-81650086
9790,2012,MOZ,7928801958,4969614147,-2959187811
9791,2012,MRT,4154775968,3000231194,-1154544774
9792,2012,MSR,16501216,2845910,-13655306
9793,2012,MUS,4765621182,2496701878,-2268919304
9794,2012,MWI,2058477485,1380669271,-677808214
9795,2012,MYS,2.16E+11,2.87E+11,71711796878
9796,2012,MYT,369139917,26953896,-342186021
9797,2012,NAM,6689987329,5100944365,-1589042964
9798,2012,NCL,2846657595,1378898770,-1467758825
9799,2012,NER,1414638086,932376149,-482261937
9800,2012,NGA,48705882966,1.28E+11,79625419479
9801,2012,NIC,6515624819,5187495667,-1328129152
9802,2012,NIU,14101780,3407465,-10694315
9803,2012,NLD,6.32E+11,5.59E+11,-73361475584
9804,2012,NOR,93992791546,1.70E+11,75775028649
9805,2012,NPL,5567396249,672592639,-4894803610
9806,2012,NRU,47853483,97174070,49320587
9807,2012,NZL,37373000113,36894361301,-478638812
9808,2012,OMN,29002544941,48996410450,19993865509
9809,2012,PAK,46827553249,24904260227,-21923293022
9810,2012,PAN,70715427232,8424950949,-62290476283
9811,2012,PCN,6084848,6473555,388707
9812,2012,PER,42515327440,42424883628,-90443812
9813,2012,PHL,97355223317,72235150438,-25120072879
9814,2012,PLW,117579762,24217909,-93361853
9815,2012,PNG,8236435637,6828917600,-1407518037
9816,2012,POL,2.23E+11,1.78E+11,-45039998393
9817,2012,PRK,4288805450,3112710232,-1176095218
9818,2012,PRT,69138833767,57587461731,-11551372036
9819,2012,PRY,12152204426,7686119399,-4466085027
9820,2012,PSE,3785575573,772876215,-3012699358
9821,2012,PYF,1659294270,226719690,-1432574580
9822,2012,QAT,25749884306,1.28E+11,1.02E+11
9823,2012,ROU,67443140345,57678051588,-9765088757
9824,2012,RUS,3.32E+11,5.87E+11,2.55E+11
9825,2012,RWA,1412669706,319911633,-1092758073
9826,2012,SAU,1.57E+11,5.64E+11,4.07E+11
9827,2012,SDN,9220519549,4708183988,-4512335561
9828,2012,SEN,9453115375,2994044801,-6459070574
9829,2012,SGP,3.62E+11,4.05E+11,42341203710
9830,2012,SHN,81632667,18197743,-63434924
9831,2012,SLB,450686332,624440085,173753753
9832,2012,SLE,1525553302,977610279,-547943023
9833,2012,SLV,9272165080,5591879217,-3680285863
9834,2012,SMR,360308506,123857571,-236450935
9835,2012,SOM,1925622287,427683582,-1497938705
9836,2012,SPM,56995930,6887573,-50108357
9837,2012,SRB,19108897293,11305082554,-7803814739
9838,2012,SSD,134841993,613976165,479134172
9839,2012,STP,134278522,14984001,-119294521
9840,2012,SUR,2012001025,1850224651,-161776374
9841,2012,SVK,77996589957,79476470997,1479881040
9842,2012,SVN,30291308459,27834002226,-2457306233
9843,2012,SWE,1.57E+11,1.68E+11,10983494428
9844,2012,SWZ,1853657499,2097862207,244204708
9845,2012,SXM,729737795,51067381,-678670414
9846,2012,SYC,750257763,459278737,-290979026
9847,2012,SYR,8448165074,2160501889,-6287663185
9848,2012,TCA,277838158,83471100,-194367058
9849,2012,TCD,846756584,3142370717,2295614133
9850,2012,TGO,10795695355,2124938737,-8670756618
9851,2012,THA,2.29E+11,2.42E+11,13633244702
9852,2012,TJK,3982547572,1053832816,-2928714756
9853,2012,TKL,54425438,41000257,-13425181
9854,2012,TKM,8634754558,10261192080,1626437522
9855,2012,TLS,693280165,629116608,-64163557
9856,2012,TON,184616036,13482839,-171133197
9857,2012,TTO,9955318346,19843615713,9888297367
9858,2012,TUN,24923820881,17918283289,-7005537592
9859,2012,TUR,2.21E+11,1.47E+11,-74615929716
9860,2012,TUV,243152357,29436553,-213715804
9861,2012,TWN,5.54E+11,3.68E+11,-1.85E+11
9862,2012,TZA,13863697829,5223326701,-8640371128
9863,2012,UGA,5148409579,2606388002,-2542021577
9864,2012,UKR,89667439587,75648863731,-14018575856
9865,2012,URY,14381044369,10268161837,-4112882532
9866,2012,USA,2.22E+12,1.55E+12,-6.73E+11
9867,2012,UZB,10952795629,5285138755,-5667656874
9868,2012,VAT,86083244,8255140,-77828104
9869,2012,VCT,485112266,79736563,-405375703
9870,2012,VEN,67833484802,81372861584,13539376782
9871,2012,VGB,3282516735,1199278242,-2083238493
9872,2012,VNM,1.29E+11,1.28E+11,-1596688133
9873,2012,VUT,650122300,437949469,-212172831
9874,2012,WLF,43031987,1238039,-41793948
9875,2012,WSM,380514085,53563999,-326950086
9876,2012,YEM,12985819036,8939157112,-4046661924
9877,2012,ZAF,1.12E+11,1.37E+11,25125823834
9878,2012,ZMB,7980714898,8628478627,647763729
9879,2012,ZWE,5284616929,2639756804,-2644860125
9880,2013,ABW,3416226733,604799544,-2811427189
9881,2013,AGO,28919165467,70994855903,42075690436
9882,2013,AIA,142458690,12216679,-130242011
9883,2013,ALB,4707776756,2754088663,-1953688093
9884,2013,AND,1463900049,290146141,-1173753908
9885,2013,ARE,2.59E+11,3.74E+11,1.15E+11
9886,2013,ARG,74137221056,76626709526,2489488470
9887,2013,ARM,3660159856,1572823552,-2087336304
9888,2013,ASM,252150064,52277284,-199872780
9889,2013,ATA,29292369,29238953,-53416
9890,2013,ATG,1620011341,369456839,-1250554502
9891,2013,AUS,2.18E+11,2.51E+11,33199843723
9892,2013,AUT,1.82E+11,1.65E+11,-16418424434
9893,2013,AZE,17105229449,31753807910,14648578461
9894,2013,BDI,597519822,186029865,-411489957
9895,2013,BEL,4.52E+11,4.86E+11,34359229673
9896,2013,BEN,8505351307,1037901282,-7467450025
9897,2013,BFA,3105379868,1813185866,-1292194002
9898,2013,BGD,39390609004,30060444229,-9330164775
9899,2013,BGR,34837821730,29624301268,-5213520462
9900,2013,BHR,20528877051,15632963664,-4895913387
9901,2013,BHS,9555296685,2798863177,-6756433508
9902,2013,BIH,9097177848,5368147234,-3729030614
9903,2013,BLM,79713700,3613223,-76100477
9904,2013,BLR,39044219985,34775275597,-4268944388
9905,2013,BLZ,1256142667,524352265,-731790402
9906,2013,BMU,3025298365,388080356,-2637218009
9907,2013,BOL,9264091553,11988331511,2724239958
9908,2013,BRA,2.46E+11,2.51E+11,5216336538
9909,2013,BRB,1907629537,434049149,-1473580388
9910,2013,BRN,7103821782,10666230687,3562408905
9911,2013,BTN,269717516,156126959,-113590557
9912,2013,BWA,7992868381,7224113501,-768754880
9913,2013,CAF,409346003,121824170,-287521833
9914,2013,CAN,4.99E+11,4.59E+11,-39530212421
9915,2013,CCK,29679683,6579444,-23100239
9916,2013,CHE,2.83E+11,3.34E+11,50995308197
9917,2013,CHL,74528536079,80468635086,5940099007
9918,2013,CHN,1.75E+12,2.43E+12,6.80E+11
9919,2013,CIV,11504038254,13488912551,1984874297
9920,2013,CMR,8487590480,5460824573,-3026765907
9921,2013,COD,7017088476,7728610625,711522149
9922,2013,COG,7911478158,12320518872,4409040714
9923,2013,COK,168325587,25284233,-143041354
9924,2013,COL,58712293389,65918024308,7205730919
9925,2013,COM,239179625,56406426,-182773199
9926,2013,CPV,920983756,128874776,-792108980
9927,2013,CRI,16473722372,35803166987,19329444615
9928,2013,CUB,7044039080,2983051918,-4060987162
9929,2013,CUW,2841183421,3581776095,740592674
9930,2013,CXR,55512862,29251405,-26261457
9931,2013,CYM,2415000977,825713358,-1589287619
9932,2013,CYP,14763443378,5429678630,-9333764748
9933,2013,CZE,1.51E+11,1.59E+11,7851611140
9934,2013,DEU,1.21E+12,1.44E+12,2.26E+11
9935,2013,DJI,3527258066,162828269,-3364429797
9936,2013,DMA,239462170,78962441,-160499729
9937,2013,DNK,95568053175,1.00E+11,4682866505
9938,2013,DOM,17578917929,8783887099,-8795030830
9939,2013,DZA,55426418315,64255459292,8829040977
9940,2013,ECU,27085627454,28418069884,1332442430
9941,2013,EGY,71935296374,33137988393,-38797307981
9942,2013,ERI,564412231,208212031,-356200200
9943,2013,ESH,914687,1729955,815268
9944,2013,ESP,3.34E+11,2.98E+11,-36374046644
9945,2013,EST,23000606280,18033342388,-4967263892
9946,2013,ETH,11348284546,4123355267,-7224929279
9947,2013,FIN,83294278635,75279042358,-8015236277
9948,2013,FJI,2704851943,983129729,-1721722214
9949,2013,FLK,135563553,184935204,49371651
9950,2013,FRA,7.30E+11,5.71E+11,-1.59E+11
9951,2013,FRO,937821166,1274591680,336770514
9952,2013,FSM,158947274,38021755,-120925519
9953,2013,GAB,4173481919,11191153572,7017671653
9954,2013,GBR,6.50E+11,5.02E+11,-1.49E+11
9955,2013,GEO,9449963659,3373914478,-6076049181
9956,2013,GHA,18647212841,12414693110,-6232519731
9957,2013,GIB,18625809975,596105732,-18029704243
9958,2013,GIN,4093279124,2397755426,-1695523698
9959,2013,GMB,1055501889,139143885,-916358004
9960,2013,GNB,319794576,288271820,-31522756
9961,2013,GNQ,3177346978,14013535886,10836188908
9962,2013,GRC,62559207956,33963230389,-28595977567
9963,2013,GRD,245752299,53588213,-192164086
9964,2013,GRL,846324770,801527717,-44797053
9965,2013,GTM,16125934460,10767672094,-5358262366
9966,2013,GUM,949248675,114894455,-834354220
9967,2013,GUY,1984466251,1204859072,-779607179
9968,2013,HKG,7.32E+11,2.40E+11,-4.91E+11
9969,2013,HND,10555148224,7988346202,-2566802022
9970,2013,HRV,21685979426,12458533281,-9227446145
9971,2013,HTI,3663892259,1003182340,-2660709919
9972,2013,HUN,99922067597,1.06E+11,6324494896
9973,2013,IDN,2.05E+11,2.02E+11,-2890509466
9974,2013,IND,4.31E+11,3.28E+11,-1.03E+11
9975,2013,IOT,82139314,32572157,-49567157
9976,2013,IRL,77599720170,1.39E+11,61556107780
9977,2013,IRN,64451089920,99129313103,34678223183
9978,2013,IRQ,56257371119,85428056184,29170685065
9979,2013,ISL,4481786197,4441936609,-39849588
9980,2013,ISR,73992435677,73623667127,-368768550
9981,2013,ITA,4.61E+11,5.11E+11,49511721223
9982,2013,JAM,6112643919,1412695076,-4699948843
9983,2013,JOR,25901869983,7651607457,-18250262526
9984,2013,JPN,7.97E+11,7.72E+11,-25078792321
9985,2013,KAZ,52789111652,79050936914,26261825262
9986,2013,KEN,18977958220,6522755812,-12455202408
9987,2013,KGZ,9730098574,1425321705,-8304776869
9988,2013,KHM,15421237082,10571534080,-4849703002
9989,2013,KIR,175790424,81212486,-94577938
9990,2013,KNA,434531797,106010340,-328521457
9991,2013,KOR,5.15E+11,5.75E+11,60412905535
9992,2013,KWT,31903577488,1.06E+11,74363228970
9993,2013,LAO,6653674457,3852147947,-2801526510
9994,2013,LBN,23321166726,4597370780,-18723795946
9995,2013,LBR,13712563420,1263619739,-12448943681
9996,2013,LBY,26408312879,40974068026,14565755147
9997,2013,LCA,1111578955,165353506,-946225449
9998,2013,LKA,19627558498,10596160292,-9031398206
9999,2013,LSO,1717795219,898611535,-819183684
10000,2013,LTU,36454369337,33472059056,-2982310281
10001,2013,LUX,28348025641,18133266572,-10214759069
10002,2013,LVA,28697690917,14679873767,-14017817150
10003,2013,MAC,10981994704,1792457788,-9189536916
10004,2013,MAR,44290269257,24948392010,-19341877247
10005,2013,MDA,5835396394,2844207743,-2991188651
10006,2013,MDG,3405127018,2091991149,-1313135869
10007,2013,MDV,1164302504,233869330,-930433174
10008,2013,MEX,4.09E+11,3.83E+11,-25291769840
10009,2013,MHL,13515610768,514381618,-13001229150
10010,2013,MKD,6119865329,4651578647,-1468286682
10011,2013,MLI,3009401399,1729401997,-1279999402
10012,2013,MLT,18287593037,6209422346,-12078170691
10013,2013,MMR,19060864497,11419797596,-7641066901
10014,2013,MNE,2538521768,646719939,-1891801829
10015,2013,MNG,6615113408,3998247262,-2616866146
10016,2013,MNP,94568144,4764692,-89803452
10017,2013,MOZ,12231435298,5445156242,-6786279056
10018,2013,MRT,4473183007,3072836587,-1400346420
10019,2013,MSR,28698788,4276766,-24422022
10020,2013,MUS,4758720574,2860090714,-1898629860
10021,2013,MWI,2530932853,1201824243,-1329108610
10022,2013,MYS,2.30E+11,2.84E+11,53752407415
10023,2013,MYT,494505467,25429512,-469075955
10024,2013,NAM,7345730377,6531299746,-814430631
10025,2013,NCL,2705280489,1365451002,-1339829487
10026,2013,NER,1742258479,1139454324,-602804155
10027,2013,NGA,53272785964,1.05E+11,51245221347
10028,2013,NIC,5985319477,5263812221,-721507256
10029,2013,NIU,16280105,1564255,-14715850
10030,2013,NLD,6.44E+11,5.93E+11,-50585479007
10031,2013,NOR,98837871411,1.67E+11,68252575511
10032,2013,NPL,6603740000,923023161,-5680716839
10033,2013,NRU,157047574,65466902,-91580672
10034,2013,NZL,38312036346,39183801467,871765121
10035,2013,OMN,36579410539,57293802575,20714392036
10036,2013,PAK,49072913793,24928325585,-24144588208
10037,2013,PAN,64507287770,6819087139,-57688200631
10038,2013,PCN,3529762,1492268,-2037494
10039,2013,PER,42027185281,40558995151,-1468190130
10040,2013,PHL,1.00E+11,74762248349,-25696675710
10041,2013,PLW,115536365,15726378,-99809987
10042,2013,PNG,6180004116,5682473824,-497530292
10043,2013,POL,2.35E+11,2.01E+11,-34400029304
10044,2013,PRK,4368743525,3586624897,-782118628
10045,2013,PRT,75904041860,61836148828,-14067893032
10046,2013,PRY,12963601712,9814874147,-3148727565
10047,2013,PSE,4286351392,898743339,-3387608053
10048,2013,PYF,1603624435,188921187,-1414703248
10049,2013,QAT,29971052721,1.35E+11,1.05E+11
10050,2013,ROU,71373658329,65045277289,-6328381040
10051,2013,RUS,3.34E+11,5.83E+11,2.49E+11
10052,2013,RWA,1403734006,346763230,-1056970776
10053,2013,SAU,1.73E+11,5.47E+11,3.75E+11
10054,2013,SDN,8819902805,4982888273,-3837014532
10055,2013,SEN,8794419686,2392482629,-6401937057
10056,2013,SGP,3.60E+11,4.13E+11,53124321261
10057,2013,SHN,87623090,21083832,-66539258
10058,2013,SLB,452589075,606149282,153560207
10059,2013,SLE,1383882024,1834321144,450439120
10060,2013,SLV,9597157682,5659695264,-3937462418
10061,2013,SMR,349954167,128814235,-221139932
10062,2013,SOM,2819296533,574007656,-2245288877
10063,2013,SPM,76342895,5573003,-70769892
10064,2013,SRB,22018723582,14891846691,-7126876891
10065,2013,SSD,445784772,2351799205,1906014433
10066,2013,STP,139462453,10031947,-129430506
10067,2013,SUR,2510712182,1968741908,-541970274
10068,2013,SVK,82933797513,84216318981,1282521468
10069,2013,SVN,31786757941,29592849154,-2193908787
10070,2013,SWE,1.57E+11,1.66E+11,9474129068
10071,2013,SWZ,1756489417,2376408618,619919201
10072,2013,SXM,1069720801,68126035,-1001594766
10073,2013,SYC,890513140,593229243,-297283897
10074,2013,SYR,6634705665,1486413743,-5148291922
10075,2013,TCA,267661986,34005825,-233656161
10076,2013,TCD,1313440184,3022904567,1709464383
10077,2013,TGO,10400313761,2298310368,-8102003393
10078,2013,THA,2.27E+11,2.44E+11,16644444043
10079,2013,TJK,4454591329,858728761,-3595862568
10080,2013,TKL,12076891,37700839,25623948
10081,2013,TKM,9228220406,10980456525,1752236119
10082,2013,TLS,539532051,828804809,289272758
10083,2013,TON,199218808,13303763,-185915045
10084,2013,TTO,11662891091,21224357285,9561466194
10085,2013,TUN,25564265679,18670331915,-6893933764
10086,2013,TUR,2.34E+11,1.54E+11,-80231663761
10087,2013,TUV,106726477,24119077,-82607400
10088,2013,TWN,5.73E+11,4.06E+11,-1.67E+11
10089,2013,TZA,16297665269,4956824650,-11340840619
10090,2013,UGA,4724656259,2588266965,-2136389294
10091,2013,UKR,84323589266,67410180158,-16913409108
10092,2013,URY,14333552411,10539063976,-3794488435
10093,2013,USA,2.22E+12,1.58E+12,-6.44E+11
10094,2013,UZB,12971418108,6858414542,-6113003566
10095,2013,VAT,77353905,3052884,-74301021
10096,2013,VCT,552453933,70373108,-482080825
10097,2013,VEN,49714369930,74293860074,24579490144
10098,2013,VGB,2389998708,790831170,-1599167538
10099,2013,VNM,1.55E+11,1.50E+11,-5217945971
10100,2013,VUT,979107257,353387068,-625720189
10101,2013,WLF,44517384,806058,-43711326
10102,2013,WSM,351552833,57925645,-293627188
10103,2013,YEM,15168849759,10096981786,-5071867973
10104,2013,ZAF,1.10E+11,1.37E+11,26492602252
10105,2013,ZMB,8837613203,12444134660,3606521457
10106,2013,ZWE,5969233264,2599641581,-3369591683
10107,2014,ABW,3650796403,578388258,-3072408145
10108,2014,AGO,31751167405,62994611046,31243443641
10109,2014,AIA,93741274,18676093,-75065181
10110,2014,ALB,5161154870,2777359382,-2383795488
10111,2014,AND,1639114207,356867414,-1282246793
10112,2014,ARE,2.67E+11,3.52E+11,85578919822
10113,2014,ARG,65705441779,68624470546,2919028767
10114,2014,ARM,4167343892,1554652252,-2612691640
10115,2014,ASM,226075650,61438747,-164636903
10116,2014,ATA,26392476,14747305,-11645171
10117,2014,ATG,1228643028,249149472,-979493556
10118,2014,AUS,2.14E+11,2.41E+11,26629022203
10119,2014,AUT,1.82E+11,1.69E+11,-12886758414
10120,2014,AZE,15339427134,29061470416,13722043282
10121,2014,BDI,603449062,166285046,-437164016
10122,2014,BEL,4.40E+11,4.56E+11,15977593552
10123,2014,BEN,9114334993,1291006815,-7823328178
10124,2014,BFA,3222097719,2202405968,-1019691751
10125,2014,BGD,40754043374,32964155948,-7789887426
10126,2014,BGR,36012337744,29880689233,-6131648511
10127,2014,BHR,21190186078,24494446091,3304260013
10128,2014,BHS,11144378836,3983288450,-7161090386
10129,2014,BIH,9719091676,5672101769,-4046989907
10130,2014,BLM,27643929,5324114,-22319815
10131,2014,BLR,39040819959,33689253890,-5351566069
10132,2014,BLZ,1106226552,458503541,-647723011
10133,2014,BMU,3508130387,82300431,-3425829956
10134,2014,BOL,10958674410,12333368634,1374694224
10135,2014,BRA,2.33E+11,2.39E+11,5157269696
10136,2014,BRB,1693013936,485739688,-1207274248
10137,2014,BRN,6486935589,9798232737,3311297148
10138,2014,BTN,269441082,175097701,-94343381
10139,2014,BWA,7506761869,7640291821,133529952
10140,2014,CAF,254282948,71390789,-182892159
10141,2014,CAN,4.99E+11,4.79E+11,-19406599827
10142,2014,CCK,56263404,10281378,-45982026
10143,2014,CHE,2.59E+11,3.01E+11,41412614310
10144,2014,CHL,68918149260,78904704901,9986555641
10145,2014,CHN,1.74E+12,2.57E+12,8.26E+11
10146,2014,CIV,11331691371,13779681996,2447990625
10147,2014,CMR,8662555722,5931605067,-2730950655
10148,2014,COD,6555509605,7894260983,1338751378
10149,2014,COG,5846776454,12119706362,6272929908
10150,2014,COK,172416533,32931042,-139485491
10151,2014,COL,63098866960,62122360778,-976506182
10152,2014,COM,251553951,58838239,-192715712
10153,2014,CPV,713043276,93659696,-619383580
10154,2014,CRI,15780399472,32759659740,16979260268
10155,2014,CUB,6032447059,2239263150,-3793183909
10156,2014,CUW,2841391372,2271869378,-569521994
10157,2014,CXR,44778452,36083360,-8695092
10158,2014,CYM,2697438058,399707769,-2297730289
10159,2014,CYP,11733829173,3713520533,-8020308640
10160,2014,CZE,1.61E+11,1.72E+11,11436085393
10161,2014,DEU,1.22E+12,1.49E+12,2.66E+11
10162,2014,DJI,3595838714,150882602,-3444956112
10163,2014,DMA,245554800,96616538,-148938262
10164,2014,DNK,1.00E+11,1.01E+11,661287874
10165,2014,DOM,17893103261,9670382373,-8222720888
10166,2014,DZA,60026931197,63472568213,3445637016
10167,2014,ECU,27110279779,29393448505,2283168726
10168,2014,EGY,83549288436,31263980238,-52285308198
10169,2014,ERI,475744276,556691563,80947287
10170,2014,ESH,5321421,4465785,-855636
10171,2014,ESP,3.51E+11,3.08E+11,-43649368688
10172,2014,EST,22233391091,18713182689,-3520208402
10173,2014,ETH,17549307744,5687346937,-11861960807
10174,2014,FIN,81519166481,74728942670,-6790223811
10175,2014,FJI,2955942929,1165880229,-1790062700
10176,2014,FLK,199691108,197100835,-2590273
10177,2014,FRA,7.16E+11,5.80E+11,-1.36E+11
10178,2014,FRO,972178720,1363121185,390942465
10179,2014,FSM,202585178,36395433,-166189745
10180,2014,GAB,4247208500,10128333998,5881125498
10181,2014,GBR,6.69E+11,4.86E+11,-1.83E+11
10182,2014,GEO,9639218081,3521034586,-6118183495
10183,2014,GHA,15411269334,11039228142,-4372041192
10184,2014,GIB,14062657263,1128915138,-12933742125
10185,2014,GIN,3868409344,2581700477,-1286708867
10186,2014,GMB,1139101244,121424753,-1017676491
10187,2014,GNB,406113524,252005078,-154108446
10188,2014,GNQ,2624985747,12438225639,9813239892
10189,2014,GRC,64915684597,33559441968,-31356242629
10190,2014,GRD,260158424,41744843,-218413581
10191,2014,GRL,775842387,784635255,8792868
10192,2014,GTM,16781897376,11574276903,-5207620473
10193,2014,GUM,1204070094,39630935,-1164439159
10194,2014,GUY,1765231075,1201494908,-563736167
10195,2014,HKG,6.98E+11,2.24E+11,-4.74E+11
10196,2014,HND,11479046968,8382810068,-3096236900
10197,2014,HRV,22827469732,13620622770,-9206846962
10198,2014,HTI,4164355203,1052886558,-3111468645
10199,2014,HUN,1.05E+11,1.13E+11,8575158621
10200,2014,IDN,1.95E+11,1.93E+11,-1537432237
10201,2014,IND,4.25E+11,3.18E+11,-1.07E+11
10202,2014,IOT,12229221,32068045,19838824
10203,2014,IRL,90976776375,1.42E+11,51371216520
10204,2014,IRN,75930896442,1.26E+11,50283342772
10205,2014,IRQ,58666275310,82161502427,23495227117
10206,2014,ISL,4632406009,4896329900,263923891
10207,2014,ISR,77626821646,75170881782,-2455939864
10208,2014,ITA,4.65E+11,5.29E+11,64056572134
10209,2014,JAM,5610429397,1328075606,-4282353791
10210,2014,JOR,26354127947,8239953559,-18114174388
10211,2014,JPN,7.77E+11,7.36E+11,-41085276153
10212,2014,KAZ,46158913798,65953555431,19794641633
10213,2014,KEN,21814790026,6355184804,-15459605222
10214,2014,KGZ,9620987999,946796222,-8674191777
10215,2014,KHM,15747364192,12533349865,-3214014327
10216,2014,KIR,192537209,80168242,-112368967
10217,2014,KNA,433647971,110168252,-323479719
10218,2014,KOR,5.24E+11,5.83E+11,59331523827
10219,2014,KWT,34476640517,97116035001,62639394484
10220,2014,LAO,7223388859,4673370429,-2550018430
10221,2014,LBN,22102486556,3777057517,-18325429039
10222,2014,LBR,11822770181,1037734713,-10785035468
10223,2014,LBY,18553356649,19642390220,1089033571
10224,2014,LCA,2365075906,209773985,-2155301921
10225,2014,LKA,22626791204,11651380168,-10975411036
10226,2014,LSO,1569566464,983542363,-586024101
10227,2014,LTU,35968463540,33916359880,-2052103660
10228,2014,LUX,27996293764,18777884601,-9218409163
10229,2014,LVA,31425742871,16333201648,-15092541223
10230,2014,MAC,12046149749,1411405915,-10634743834
10231,2014,MAR,45178501032,26422810974,-18755690058
10232,2014,MDA,5681151654,2946073499,-2735078155
10233,2014,MDG,3567156987,2440661498,-1126495489
10234,2014,MDV,1413467104,206070792,-1207396312
10235,2014,MEX,4.31E+11,4.10E+11,-21319587913
10236,2014,MHL,15534364964,825523045,-14708841919
10237,2014,MKD,6872637086,5594083781,-1278553305
10238,2014,MLI,3200994547,1847124718,-1353869829
10239,2014,MLT,19614269693,5733813930,-13880455763
10240,2014,MMR,22598772830,24583933992,1985161162
10241,2014,MNE,2651468413,631202237,-2020266176
10242,2014,MNG,5488895146,5579461038,90565892
10243,2014,MNP,124243292,2693215,-121550077
10244,2014,MOZ,12265680012,6782361829,-5483318183
10245,2014,MRT,3700424291,2949436794,-750987497
10246,2014,MSR,29207411,2900775,-26306636
10247,2014,MUS,5843763011,3136070956,-2707692055
10248,2014,MWI,2157606816,1495257783,-662349033
10249,2014,MYS,2.30E+11,2.92E+11,61652320580
10250,2014,NAM,8618374831,6368806980,-2249567851
10251,2014,NCL,2922446967,1546061796,-1376385171
10252,2014,NER,2845511570,830824530,-2014687040
10253,2014,NGA,56695104796,98169966519,41474861723
10254,2014,NIC,6108071292,5565889803,-542181489
10255,2014,NIU,19331546,3849326,-15482220
10256,2014,NLD,6.22E+11,5.89E+11,-33423508966
10257,2014,NOR,98409562842,1.48E+11,49426158310
10258,2014,NPL,7939592286,936789767,-7002802519
10259,2014,NRU,137501103,31357154,-106143949
10260,2014,NZL,42643566192,42026039976,-617526216
10261,2014,OMN,33879166064,51869193831,17990027767
10262,2014,PAK,52090139096,26141742645,-25948396451
10263,2014,PAN,53697692754,5233747737,-48463945017
10264,2014,PCN,2220681,1198361,-1022320
10265,2014,PER,42181723762,37989586895,-4192136867
10266,2014,PHL,1.09E+11,81743271752,-26816329202
10267,2014,PLW,134978221,17443013,-117535208
10268,2014,PNG,5600357410,8364931193,2764573783
10269,2014,POL,2.53E+11,2.12E+11,-40936200551
10270,2014,PRK,4045848313,3375108713,-670739600
10271,2014,PRT,79802822215,62803278513,-16999543702
10272,2014,PRY,12720532662,10153902083,-2566630579
10273,2014,PSE,4649972659,926624952,-3723347707
10274,2014,PYF,1659165202,191941603,-1467223599
10275,2014,QAT,36406775601,1.30E+11,93374448985
10276,2014,ROU,76128403031,70140147706,-5988255325
10277,2014,RUS,3.05E+11,5.41E+11,2.35E+11
10278,2014,RWA,1505433126,389038226,-1116394900
10279,2014,SAU,1.74E+11,5.08E+11,3.34E+11
10280,2014,SDN,7889671038,4498633743,-3391037295
10281,2014,SEN,9328042421,2630372296,-6697670125
10282,2014,SGP,3.68E+11,4.16E+11,48309491256
10283,2014,SHN,71544928,18683925,-52861003
10284,2014,SLB,421707477,640831292,219123815
10285,2014,SLE,1268462925,2132290250,863827325
10286,2014,SLV,9940638401,5472973463,-4467664938
10287,2014,SMR,342092871,146623629,-195469242
10288,2014,SOM,2556834226,589889842,-1966944384
10289,2014,SPM,75903391,3478072,-72425319
10290,2014,SRB,20904563131,15303937721,-5600625410
10291,2014,SSD,577585439,4181247249,3603661810
10292,2014,STP,156462295,19058873,-137403422
10293,2014,SUR,2011737530,1726265906,-285471624
10294,2014,SVK,84994376595,85929709991,935333396
10295,2014,SVN,33091619637,31598455294,-1493164343
10296,2014,SWE,1.59E+11,1.63E+11,3311961543
10297,2014,SWZ,1977171033,2333215226,356044193
10298,2014,SXM,969519321,76292107,-893227214
10299,2014,SYC,791462024,559331954,-232130070
10300,2014,SYR,7312237781,1100110334,-6212127447
10301,2014,TCA,330457693,24862506,-305595187
10302,2014,TCD,1442840730,2943601405,1500760675
10303,2014,TGO,12876946500,2245503147,-10631443353
10304,2014,THA,2.11E+11,2.45E+11,34084587812
10305,2014,TJK,5095116361,704948410,-4390167951
10306,2014,TKL,6472865,20762904,14290039
10307,2014,TKM,9578131758,11337457804,1759326046
10308,2014,TLS,668272883,123847991,-544424892
10309,2014,TON,196420674,13839816,-182580858
10310,2014,TTO,10813935515,19329009467,8515073952
10311,2014,TUN,25846111231,17571688864,-8274422367
10312,2014,TUR,2.29E+11,1.57E+11,-71738147195
10313,2014,TUV,121589586,7173782,-114415804
10314,2014,TWN,5.64E+11,4.12E+11,-1.52E+11
10315,2014,TZA,16178493964,5654258921,-10524235043
10316,2014,UGA,4966211737,2338796771,-2627414966
10317,2014,UKR,56871633536,58488704574,1617071038
10318,2014,URY,14268608260,10443813951,-3824794309
10319,2014,USA,2.32E+12,1.62E+12,-7.00E+11
10320,2014,UZB,13474705815,5442602497,-8032103318
10321,2014,VAT,67886535,6160863,-61725672
10322,2014,VCT,572959393,87967820,-484991573
10323,2014,VEN,38206031646,67320182276,29114150630
10324,2014,VGB,2586068951,453194144,-2132874807
10325,2014,VNM,1.84E+11,1.73E+11,-11149362483
10326,2014,VUT,700933598,312097156,-388836442
10327,2014,WLF,47754995,2002789,-45752206
10328,2014,WSM,419593378,45028016,-374565362
10329,2014,YEM,12965396941,8985859322,-3979537619
10330,2014,ZAF,1.02E+11,1.30E+11,27485086053
10331,2014,ZMB,8860810207,12430716798,3569906591
10332,2014,ZWE,5624161740,2537607353,-3086554387
10333,2015,ABW,2612925513,421033334,-2191892179
10334,2015,AGO,18194182325,34947099965,16752917640
10335,2015,AIA,76238251,11807511,-64430740
10336,2015,ALB,4409517949,2157215636,-2252302313
10337,2015,AND,1318882790,56969980,-1261912810
10338,2015,ARE,2.34E+11,2.21E+11,-12686978864
10339,2015,ARG,58655880069,57724757431,-931122638
10340,2015,ARM,2776220884,1396955137,-1379265747
10341,2015,ASM,123450495,27970805,-95479690
10342,2015,ATA,28243775,11863016,-16380759
10343,2015,ATG,1351756561,212227273,-1139529288
10344,2015,AUS,1.90E+11,1.87E+11,-2949553047
10345,2015,AUT,1.57E+11,1.45E+11,-12130380735
10346,2015,AZE,10929974454,17407372269,6477397815
10347,2015,BDI,413220540,251241111,-161979429
10348,2015,BEL,3.64E+11,3.85E+11,21138027535
10349,2015,BEN,7142314596,1136290629,-6006023967
10350,2015,BFA,2480849601,1581830186,-899019415
10351,2015,BGD,48754866076,34418732144,-14336133932
10352,2015,BGR,29788707052,25435977634,-4352729418
10353,2015,BHR,16976077274,17764267664,788190390
10354,2015,BHS,9608448689,2184758763,-7423689926
10355,2015,BIH,7853794960,4984627825,-2869167135
10356,2015,BLM,109958366,17978633,-91979733
10357,2015,BLR,27381041461,24970399376,-2410642085
10358,2015,BLZ,1006178120,408771424,-597406696
10359,2015,BMU,3884195462,247913929,-3636281533
10360,2015,BOL,7668785653,8510862793,842077140
10361,2015,BRA,1.73E+11,2.02E+11,29730868684
10362,2015,BRB,1383994256,295055922,-1088938334
10363,2015,BRN,4566170496,6007012482,1440841986
10364,2015,BTN,512588976,267499621,-245089355
10365,2015,BWA,6817499458,5691761547,-1125737911
10366,2015,CAF,282852464,70431947,-212420517
10367,2015,CAN,4.56E+11,4.10E+11,-45480446865
10368,2015,CCK,7234366,9920650,2686284
10369,2015,CHE,2.34E+11,2.68E+11,33604660121
10370,2015,CHL,62013116129,65997314492,3984198363
10371,2015,CHN,1.41E+12,2.45E+12,1.04E+12
10372,2015,CIV,9649556387,12021455010,2371898623
10373,2015,CMR,6893686761,5055051014,-1838635747
10374,2015,COD,5507722566,6059314281,551591715
10375,2015,COG,5364600943,6509387159,1144786216
10376,2015,COK,144237322,24209486,-120027836
10377,2015,COL,50663719715,43323278893,-7340440822
10378,2015,COM,437356780,49797292,-387559488
10379,2015,CPV,656291248,78460592,-577830656
10380,2015,CRI,14114584920,13678372319,-436212601
10381,2015,CUB,6916190389,1761391505,-5154798884
10382,2015,CUW,2190918684,1361832002,-829086682
10383,2015,CXR,25851615,34330247,8478632
10384,2015,CYM,2487916569,414376739,-2073539830
10385,2015,CYP,8605575658,3794096115,-4811479543
10386,2015,CZE,1.47E+11,1.54E+11,7147098071
10387,2015,DEU,1.06E+12,1.32E+12,2.56E+11
10388,2015,DJI,4368356492,128432422,-4239924070
10389,2015,DMA,205944867,88694540,-117250327
10390,2015,DNK,84766340325,86188487020,1422146695
10391,2015,DOM,16790780730,8842991988,-7947788742
10392,2015,DZA,50675687027,36930787048,-13744899979
10393,2015,ECU,20710901281,21389765738,678864457
10394,2015,EGY,75953365537,25595154146,-50358211391
10395,2015,ERI,403673362,438225288,34551926
10396,2015,ESH,1244820,1277563,32743
10397,2015,ESP,3.07E+11,2.72E+11,-34881813256
10398,2015,EST,17247984613,14010488816,-3237495797
10399,2015,ETH,12948690120,5081395496,-7867294624
10400,2015,FIN,62999633789,62650846269,-348787520
10401,2015,FJI,2280890527,880520450,-1400370077
10402,2015,FLK,255829602,192741421,-63088181
10403,2015,FRA,6.04E+11,5.07E+11,-96936619919
10404,2015,FRO,929886908,1162687457,232800549
10405,2015,FSM,168340190,22586501,-145753689
10406,2015,GAB,2773785946,5705132118,2931346172
10407,2015,GBR,6.08E+11,4.41E+11,-1.66E+11
10408,2015,GEO,7604055783,2689652445,-4914403338
10409,2015,GHA,14296572097,8956818034,-5339754063
10410,2015,GIB,9195262487,408036298,-8787226189
10411,2015,GIN,3624036886,1865453355,-1758583531
10412,2015,GMB,967882318,123932555,-843949763
10413,2015,GNB,292773002,270986239,-21786763
10414,2015,GNQ,1697914541,6321614976,4623700435
10415,2015,GRC,49322210966,27506756728,-21815454238
10416,2015,GRD,236982649,42831954,-194150695
10417,2015,GRL,643522450,792115987,148593537
10418,2015,GTM,16657038921,11634842548,-5022196373
10419,2015,GUM,752878074,33288265,-719589809
10420,2015,GUY,1459321620,1239265724,-220055896
10421,2015,HKG,6.12E+11,1.85E+11,-4.27E+11
10422,2015,HND,10844775210,8278833431,-2565941779
10423,2015,HRV,21033563624,12660298132,-8373265492
10424,2015,HTI,3586812926,1111157252,-2475655674
10425,2015,HUN,90696435945,1.03E+11,12167026025
10426,2015,IDN,1.50E+11,1.64E+11,13142732455
10427,2015,IND,3.58E+11,2.69E+11,-89350456444
10428,2015,IOT,13262787,30307560,17044773
10429,2015,IRL,80726885710,1.49E+11,68042910819
10430,2015,IRN,54998153616,37863402044,-17134751572
10431,2015,IRQ,39376736281,51801598004,12424861723
10432,2015,ISL,4663584503,3659703952,-1003880551
10433,2015,ISR,70089109782,70155746301,66636519
10434,2015,ITA,3.97E+11,4.61E+11,63872593862
10435,2015,JAM,4837773908,1208779896,-3628994012
10436,2015,JOR,21183599695,8547097099,-12636502596
10437,2015,JPN,5.99E+11,6.72E+11,73234321170
10438,2015,KAZ,32630000137,40061432100,7431431963
10439,2015,KEN,19449923461,5299526623,-14150396838
10440,2015,KGZ,7400056117,1124060631,-6275995486
10441,2015,KHM,16302610560,14072422359,-2230188201
10442,2015,KIR,178737252,122046688,-56690564
10443,2015,KNA,316461013,95682661,-220778352
10444,2015,KOR,4.33E+11,5.35E+11,1.02E+11
10445,2015,KWT,30580385551,55751732782,25171347231
10446,2015,LAO,6508964211,4252441126,-2256523085
10447,2015,LBN,18817127444,3550639450,-15266487994
10448,2015,LBR,8433117424,1020428306,-7412689118
10449,2015,LBY,12817117500,10717806781,-2099310719
10450,2015,LCA,1587833328,117413296,-1470420032
10451,2015,LKA,21186058064,11140673402,-10045384662
10452,2015,LSO,1427743997,930768766,-496975231
10453,2015,LTU,28079598455,25502890082,-2576708373
10454,2015,LUX,23242277348,16490113169,-6752164179
10455,2015,LVA,22111778318,12243341819,-9868436499
10456,2015,MAC,12912034665,1560066352,-11351968313
10457,2015,MAR,37031760044,25388222777,-11643537267
10458,2015,MDA,4052173774,2366270478,-1685903296
10459,2015,MDG,3176751274,2510834480,-665916794
10460,2015,MDV,1392405017,238021116,-1154383901
10461,2015,MEX,4.29E+11,4.00E+11,-29214382838
10462,2015,MHL,16475479749,512242753,-15963236996
10463,2015,MKD,6334412130,5284253195,-1050158935
10464,2015,MLI,2921449374,3141164616,219715242
10465,2015,MLT,18194471004,4962835018,-13231635986
10466,2015,MMR,22635687483,13831532557,-8804154926
10467,2015,MNE,2149601814,397527768,-1752074046
10468,2015,MNG,3977556853,4389533597,411976744
10469,2015,MNP,158592849,2857890,-155734959
10470,2015,MOZ,9989837794,4680314457,-5309523337
10471,2015,MRT,2684950057,1865836641,-819113416
10472,2015,MSR,16585219,4248725,-12336494
10473,2015,MUS,4551546718,3231041678,-1320505040
10474,2015,MWI,1814206730,1341005145,-473201585
10475,2015,MYS,1.95E+11,2.59E+11,63900749919
10476,2015,NAM,7541054974,4998995366,-2542059608
10477,2015,NCL,2350558768,1357133828,-993424940
10478,2015,NER,1497264873,978182874,-519081999
10479,2015,NGA,40708648464,50396239319,9687590855
10480,2015,NIC,6217065484,5251086411,-965979073
10481,2015,NIU,19119499,2104120,-17015379
10482,2015,NLD,5.09E+11,4.55E+11,-53117795702
10483,2015,NOR,86272314448,1.11E+11,24676569135
10484,2015,NPL,5419254648,810122605,-4609132043
10485,2015,NRU,85471066,30493935,-54977131
10486,2015,NZL,36162101922,34586964787,-1575137135
10487,2015,OMN,33412514372,32576715900,-835798472
10488,2015,PAK,49656886872,23249785732,-26407101140
10489,2015,PAN,40232930853,4934044183,-35298886670
10490,2015,PCN,1101943,1505748,403805
10491,2015,PER,35959620589,32111077088,-3848543501
10492,2015,PHL,1.01E+11,78018561615,-23228358468
10493,2015,PLW,110795340,14809049,-95986291
10494,2015,PNG,4940733218,8412531662,3471798444
10495,2015,POL,2.24E+11,1.93E+11,-30658284741
10496,2015,PRK,3474733885,3061177365,-413556520
10497,2015,PRT,65437622723,54122716038,-11314906685
10498,2015,PRY,10411200641,8591933779,-1819266862
10499,2015,PSE,3882341125,937818535,-2944522590
10500,2015,PYF,1354228864,193551304,-1160677560
10501,2015,QAT,34829153204,79287680247,44458527043
10502,2015,ROU,67737990483,61075674526,-6662315957
10503,2015,RUS,1.91E+11,3.60E+11,1.68E+11
10504,2015,RWA,1414253814,751301624,-662952190
10505,2015,SAU,1.65E+11,2.77E+11,1.12E+11
10506,2015,SDN,9580472045,3724437743,-5856034302
10507,2015,SEN,8448259392,2547837837,-5900421555
10508,2015,SGP,2.94E+11,3.46E+11,52436132114
10509,2015,SHN,69199024,38732898,-30466126
10510,2015,SLB,353041996,678039786,324997790
10511,2015,SLE,1200027364,612539433,-587487931
10512,2015,SLV,9759583017,5729494251,-4030088766
10513,2015,SMR,297378008,136797186,-160580822
10514,2015,SOM,2648126195,622280344,-2025845851
10515,2015,SPM,50622591,3325692,-47296899
10516,2015,SRB,18400380293,14040036351,-4360343942
10517,2015,SSD,693692050,2222445201,1528753151
10518,2015,STP,118349778,14507419,-103842359
10519,2015,SUR,1581698858,1515947276,-65751582
10520,2015,SVK,75817749301,74064471219,-1753278082
10521,2015,SVN,29858681526,27417518757,-2441162769
10522,2015,SWE,1.37E+11,1.38E+11,792377933
10523,2015,SWZ,1536042899,1941449693,405406794
10524,2015,SXM,920827620,72925151,-847902469
10525,2015,SYC,918094009,461372127,-456721882
10526,2015,SYR,5285438108,828194952,-4457243156
10527,2015,TCA,324406986,40034526,-284372460
10528,2015,TCD,909937692,2279740639,1369802947
10529,2015,TGO,9701565507,1949304394,-7752261113
10530,2015,THA,1.89E+11,2.29E+11,40875665714
10531,2015,TJK,3557780133,727245193,-2830534940
10532,2015,TKL,4203307,24101089,19897782
10533,2015,TKM,5902768308,8923125046,3020356738
10534,2015,TLS,610775071,43554094,-567220977
10535,2015,TON,172081330,11578014,-160503316
10536,2015,TTO,8682474042,12909009747,4226535705
10537,2015,TUN,20220352978,14658047542,-5562305436
10538,2015,TUR,1.96E+11,1.41E+11,-54750765390
10539,2015,TUV,73174850,35943866,-37230984
10540,2015,TWN,3.54E+11,3.74E+11,19288208859
10541,2015,TZA,17721806550,6350769991,-11371036559
10542,2015,UGA,4776172612,2405496047,-2370676565
10543,2015,UKR,38796692298,42777565201,3980872903
10544,2015,URY,12089113983,9317751925,-2771362058
10545,2015,USA,2.20E+12,1.51E+12,-6.92E+11
10546,2015,UZB,10420496801,4903569865,-5516926936
10547,2015,VAT,54880516,13232999,-41647517
10548,2015,VCT,374784928,118425540,-256359388
10549,2015,VEN,27813492813,35881542679,8068049866
10550,2015,VGB,2222060188,606373287,-1615686901
10551,2015,VNM,1.96E+11,1.94E+11,-1498273204
10552,2015,VUT,367710277,135412019,-232298258
10553,2015,WLF,31539636,1015570,-30524066
10554,2015,WSM,321815713,51273299,-270542414
10555,2015,YEM,7461650358,1920656266,-5540994092
10556,2015,ZAF,86332714397,98495280881,12162566484
10557,2015,ZMB,7509655066,5449783884,-2059871182
10558,2015,ZWE,5725997896,2346686691,-3379311205
10559,2016,ABW,1685691864,172586889,-1513104975
10560,2016,AGO,10789284563,26817207014,16027922451
10561,2016,AIA,61070437,12260774,-48809663
10562,2016,ALB,4677142990,2209523494,-2467619496
10563,2016,AND,1372762259,93164765,-1279597494
10564,2016,ARE,2.20E+11,1.95E+11,-24919793865
10565,2016,ARG,55782166691,57323302027,1541135336
10566,2016,ARM,2627571736,2075993104,-551578632
10567,2016,ASM,145467531,34626181,-110841350
10568,2016,ATA,40552979,9760626,-30792353
10569,2016,ATG,971356246,246215157,-725141089
10570,2016,AUS,1.79E+11,1.78E+11,-1006474598
10571,2016,AUT,1.60E+11,1.43E+11,-16098205832
10572,2016,AZE,8289724680,13237065965,4947341285
10573,2016,BDI,421266398,121705229,-299561169
10574,2016,BEL,3.62E+11,3.90E+11,28218701266
10575,2016,BEN,5497235370,918779782,-4578455588
10576,2016,BFA,2779719894,1232240587,-1547479307
10577,2016,BGD,42832029568,36755086248,-6076943320
10578,2016,BGR,30149148230,25935485113,-4213663117
10579,2016,BHR,12094363811,12979392426,885028615
10580,2016,BHS,6991471028,1502882341,-5488588687
10581,2016,BIH,8058633727,5311518128,-2747115599
10582,2016,BLM,122991153,11929102,-111062051
10583,2016,BLR,23559266448,22033354534,-1525911914
10584,2016,BLZ,903257895,381535548,-521722347
10585,2016,BMU,3115138463,184473418,-2930665045
10586,2016,BOL,6729469929,6709418286,-20051643
10587,2016,BRA,1.45E+11,1.96E+11,51648684272
10588,2016,BRB,1330184260,243575663,-1086608597
10589,2016,BRN,3218532383,4557270676,1338738293
10590,2016,BTN,460300796,144849568,-315451228
10591,2016,BWA,5876202820,7723735310,1847532490
10592,2016,CAF,256285235,127368959,-128916276
10593,2016,CAN,4.37E+11,3.81E+11,-55928039184
10594,2016,CCK,10287912,4353387,-5934525
10595,2016,CHE,2.38E+11,2.68E+11,29697204563
10596,2016,CHL,57447132869,62346192810,4899059941
10597,2016,CHN,1.32E+12,2.31E+12,9.95E+11
10598,2016,CIV,8631260344,12363823384,3732563040
10599,2016,CMR,5906233100,3977645117,-1928587983
10600,2016,COD,4405359742,4486020043,80660301
10601,2016,COG,4666817363,5220285749,553468386
10602,2016,COK,149389091,35094700,-114294391
10603,2016,COL,43511652987,37202311442,-6309341545
10604,2016,COM,433476190,76961854,-356514336
10605,2016,CPV,798233561,95505112,-702728449
10606,2016,CRI,15005973620,13454900732,-1551072888
10607,2016,CUB,6824308610,1435968497,-5388340113
10608,2016,CUW,1755761995,1189445821,-566316174
10609,2016,CXR,33628821,23093977,-10534844
10610,2016,CYM,4589599606,1214211324,-3375388282
10611,2016,CYP,9107769663,2952018090,-6155751573
10612,2016,CZE,1.48E+11,1.59E+11,11243792305
10613,2016,DEU,1.05E+12,1.33E+12,2.76E+11
10614,2016,DJI,4430499546,105084385,-4325415161
10615,2016,DMA,185895980,55701657,-130194323
10616,2016,DNK,84358820522,87029151440,2670330918
10617,2016,DOM,17995951250,8911003473,-9084947777
10618,2016,DZA,49375948286,31198871450,-18177076836
10619,2016,ECU,16196935688,19275531735,3078596047
10620,2016,EGY,68194731636,25039708859,-43155022777
10621,2016,ERI,341636589,322611201,-19025388
10622,2016,ESH,2180930,8466819,6285889
10623,2016,ESP,3.05E+11,2.77E+11,-28960588860
10624,2016,EST,17723954518,14373295785,-3350658733
10625,2016,ETH,12134778503,2642719618,-9492058885
10626,2016,FIN,64678506626,60672380519,-4006126107
10627,2016,FJI,2251912070,824272069,-1427640001
10628,2016,FLK,85982046,244421932,158439886
10629,2016,FRA,6.01E+11,5.07E+11,-93472485834
10630,2016,FRO,865193926,1373669501,508475575
10631,2016,FSM,178864886,58707021,-120157865
10632,2016,GAB,1990656951,3816013210,1825356259
10633,2016,GBR,6.00E+11,3.97E+11,-2.04E+11
10634,2016,GEO,7852295947,2327986841,-5524309106
10635,2016,GHA,14751392844,10207056559,-4544336285
10636,2016,GIB,8675551052,260091962,-8415459090
10637,2016,GIN,3466282686,2565690630,-900592056
10638,2016,GMB,943264961,162084092,-781180869
10639,2016,GNB,294983564,339304924,44321360
10640,2016,GNQ,1132348972,4392990046,3260641074
10641,2016,GRC,50139883039,27176434715,-22963448324
10642,2016,GRD,192575510,36843064,-155732446
10643,2016,GRL,726225959,867258305,141032346
10644,2016,GTM,15806869986,11418636448,-4388233538
10645,2016,GUM,740161957,27729675,-712432282
10646,2016,GUY,1742728507,1253471630,-489256877
10647,2016,HKG,5.75E+11,1.12E+11,-4.63E+11
10648,2016,HND,11092938474,8291046714,-2801891760
10649,2016,HRV,21706637215,13076634478,-8630002737
10650,2016,HTI,3395619872,1072022388,-2323597484
10651,2016,HUN,90899401454,1.05E+11,14296780378
10652,2016,IDN,1.42E+11,1.57E+11,15122699915
10653,2016,IND,3.28E+11,2.60E+11,-67680531384
10654,2016,IOT,32894427,19145668,-13748759
10655,2016,IRL,86101996800,1.55E+11,68981388206
10656,2016,IRN,56749313589,93428238278,36678924689
10657,2016,IRQ,40482485783,45912299471,5429813688
10658,2016,ISL,5815142261,4008113795,-1807028466
10659,2016,ISR,74543986547,63969731309,-10574255238
10660,2016,ITA,3.92E+11,4.58E+11,65979808571
10661,2016,JAM,4721936784,1075143282,-3646793502
10662,2016,JOR,19191551673,7591457350,-11600094323
10663,2016,JPN,5.64E+11,6.85E+11,1.22E+11
10664,2016,KAZ,29928809905,36166891259,6238081354
10665,2016,KEN,16364620258,4812826655,-11551793603
10666,2016,KGZ,8292775259,797596175,-7495179084
10667,2016,KHM,16926175768,15846423688,-1079752080
10668,2016,KIR,141511435,130559558,-10951877
10669,2016,KNA,326638178,81640156,-244998022
10670,2016,KOR,3.98E+11,5.08E+11,1.10E+11
10671,2016,KWT,29850829106,42119157617,12268328511
10672,2016,LAO,5978919487,4254629789,-1724289698
10673,2016,LBN,19010534127,3359058101,-15651476026
10674,2016,LBR,9600468881,857410023,-8743058858
10675,2016,LBY,9915169466,7757257181,-2157912285
10676,2016,LCA,1199018669,140522165,-1058496504
10677,2016,LKA,19019034915,10743299850,-8275735065
10678,2016,LSO,1339256005,895096315,-444159690
10679,2016,LTU,27844539633,25507026705,-2337512928
10680,2016,LUX,21927772188,16021885832,-5905886356
10681,2016,LVA,19613485615,12577947990,-7035537625
10682,2016,MAC,10598615517,1471573585,-9127041932
10683,2016,MAR,40360733565,26245377088,-14115356477
10684,2016,MDA,4347550738,2328250668,-2019300070
10685,2016,MDG,3212031894,2724795300,-487236594
10686,2016,MDV,1634270449,270995057,-1363275392
10687,2016,MEX,4.27E+11,3.84E+11,-42732064284
10688,2016,MHL,17122838223,534849844,-16587988379
10689,2016,MKD,6786385907,5732420236,-1053965671
10690,2016,MLI,4422852965,1490002951,-2932850014
10691,2016,MLT,14083343658,5393296377,-8690047281
10692,2016,MMR,22033465042,12384492429,-9648972613
10693,2016,MNE,2443552417,443424814,-2000127603
10694,2016,MNG,3238719488,4257730728,1019011240
10695,2016,MNP,132665584,3966931,-128698653
10696,2016,MOZ,7871761163,4254021586,-3617739577
10697,2016,MRT,2800018184,2097796989,-702221195
10698,2016,MSR,36621844,3203340,-33418504
10699,2016,MUS,4630569182,2427093402,-2203475780
10700,2016,MWI,1767097574,1184846852,-582250722
10701,2016,MYS,1.78E+11,2.49E+11,71157428298
10702,2016,NAM,6624969714,4758208669,-1866761045
10703,2016,NCL,2060913463,1286093468,-774819995
10704,2016,NER,1026000038,620588380,-405411658
10705,2016,NGA,34961690737,38203015283,3241324546
10706,2016,NIC,6818225693,5249591075,-1568634618
10707,2016,NIU,18473494,2177685,-16295809
10708,2016,NLD,4.98E+11,4.58E+11,-39238746364
10709,2016,NOR,81722171962,96300821550,14578649588
10710,2016,NPL,6844413426,747479627,-6096933799
10711,2016,NRU,54812011,20919791,-33892220
10712,2016,NZL,36039598091,34116209627,-1923388464
10713,2016,OMN,25177706735,27718453297,2540746562
10714,2016,PAK,51654522654,21855726737,-29798795917
10715,2016,PAN,34651332577,9073471617,-25577860960
10716,2016,PCN,3366485,1219135,-2147350
10717,2016,PER,36050661325,34234636008,-1816025317
10718,2016,PHL,1.06E+11,76517562830,-29608689249
10719,2016,PLW,123608945,22731138,-100877807
10720,2016,PNG,4105700553,7406560660,3300860107
10721,2016,POL,2.25E+11,1.95E+11,-29795748249
10722,2016,PRK,3140573160,2890333732,-250239428
10723,2016,PRT,67202072758,54135954429,-13066118329
10724,2016,PRY,10464379547,8662673305,-1801706242
10725,2016,PSE,4009342925,914314244,-3095028681
10726,2016,PYF,1293164678,170141478,-1123023200
10727,2016,QAT,33142123122,58181393983,25039270861
10728,2016,ROU,71610625217,64132398506,-7478226711
10729,2016,RUS,1.93E+11,3.04E+11,1.11E+11
10730,2016,RWA,1660263163,693386008,-966877155
10731,2016,SAU,1.34E+11,1.69E+11,35324087381
10732,2016,SDN,7289187286,2695282131,-4593905155
10733,2016,SEN,8610153608,3011308287,-5598845321
10734,2016,SGP,2.77E+11,3.25E+11,48727484631
10735,2016,SHN,47400485,25362974,-22037511
10736,2016,SLB,412423199,584925332,172502133
10737,2016,SLE,1139002758,649741625,-489261133
10738,2016,SLV,9616404550,5668719870,-3947684680
10739,2016,SMR,284832894,173144985,-111687909
10740,2016,SOM,2292512248,563058828,-1729453420
10741,2016,SPM,61947508,4851094,-57096414
10742,2016,SRB,19240150840,15349310340,-3890840500
10743,2016,SSD,411586720,1405875228,994288508
10744,2016,STP,141976947,15571959,-126404988
10745,2016,SUR,1265650543,1052210379,-213440164
10746,2016,SVK,75078679202,76891950359,1813271157
10747,2016,SVN,31443200241,29089024344,-2354175897
10748,2016,SWE,1.39E+11,1.37E+11,-1282189933
10749,2016,SWZ,1409249231,1745196663,335947432
10750,2016,SXM,855000661,115792224,-739208437
10751,2016,SYC,838274894,562894864,-275380030
10752,2016,SYR,4804490058,816517765,-3987972293
10753,2016,TCA,334107026,28127817,-305979209
10754,2016,TCD,655987268,1521297718,865310450
10755,2016,TGO,7886319077,1513086935,-6373232142
10756,2016,THA,1.78E+11,2.34E+11,55533122374
10757,2016,TJK,3498692177,699211139,-2799481038
10758,2016,TKL,4581309,16938670,12357361
10759,2016,TKM,5584407275,7162031918,1577624643
10760,2016,TLS,589819539,60652351,-529167188
10761,2016,TON,198975196,14111519,-184863677
10762,2016,TTO,5960202520,8241901973,2281699453
10763,2016,TUN,19840351005,14434984518,-5405366487
10764,2016,TUR,1.88E+11,1.40E+11,-48194883623
10765,2016,TUV,58119743,41434217,-16685526
10766,2016,TWN,2.88E+11,3.74E+11,85936669718
10767,2016,TZA,10496369518,4952259067,-5544110451
10768,2016,UGA,4464062097,2295649595,-2168412502
10769,2016,UKR,42378989670,39191849350,-3187140320
10770,2016,URY,11095323787,8654641820,-2440681967
10771,2016,USA,2.13E+12,1.44E+12,-6.87E+11
10772,2016,UZB,9766084197,5508326225,-4257757972
10773,2016,VAT,43722376,4315633,-39406743
10774,2016,VCT,326843208,236695733,-90147475
10775,2016,VEN,15516612182,26509626688,10993014506
10776,2016,VGB,1497289403,658327568,-838961835
10777,2016,VNM,2.03E+11,2.12E+11,9821417300
10778,2016,VUT,361282449,272903324,-88379125
10779,2016,WLF,32498718,718078,-31780640
10780,2016,WSM,359345570,53697757,-305647813
10781,2016,YEM,7025225431,528852190,-6496373241
10782,2016,ZAF,75140669854,89860485299,14719815445
10783,2016,ZMB,4007142398,5700138759,1692996361
10784,2016,ZWE,4770902562,1989834619,-2781067943
10785,2017,ABW,1710232785,271125426,-1439107359
10786,2017,AGO,11667715486,34560877094,22893161608
10787,2017,AIA,92612670,12237037,-80375633
10788,2017,ALB,5317846204,2459503893,-2858342311
10789,2017,AND,1476094232,109866483,-1366227749
10790,2017,ARE,2.63E+11,2.70E+11,6742410205
10791,2017,ARG,65529354507,58381034383,-7148320124
10792,2017,ARM,3076544151,2244379588,-832164563
10793,2017,ASM,134171350,32792444,-101378906
10794,2017,ATA,33569472,5360836,-28208636
10795,2017,ATG,1035323539,225743269,-809580270
10796,2017,AUS,2.09E+11,2.28E+11,19852182260
10797,2017,AUT,1.76E+11,1.58E+11,-17358062725
10798,2017,AZE,9229734782,18077585869,8847851087
10799,2017,BDI,556756535,142701988,-414054547
10800,2017,BEL,3.92E+11,4.22E+11,29467329923
10801,2017,BEN,5325247215,1240738517,-4084508698
10802,2017,BFA,3385662613,1519326758,-1866335855
10803,2017,BGD,47991421973,38490101367,-9501320606
10804,2017,BGR,34960885058,30944279034,-4016606024
10805,2017,BHR,10166741961,8268044081,-1898697880
10806,2017,BHS,9077153027,1254368126,-7822784901
10807,2017,BIH,9241414866,6272678468,-2968736398
10808,2017,BLM,137500088,23514770,-113985318
10809,2017,BLR,27647326632,27474847743,-172478889
10810,2017,BLZ,1033668354,508695955,-524972399
10811,2017,BMU,2156059203,164733921,-1991325282
10812,2017,BOL,9804305929,7666425797,-2137880132
10813,2017,BRA,1.67E+11,2.26E+11,58820857198
10814,2017,BRB,1538248777,297964063,-1240284714
10815,2017,BRN,2814547944,4769670210,1955122266
10816,2017,BTN,508031087,237831735,-270199352
10817,2017,BWA,6080194082,7647359002,1567164920
10818,2017,CAF,278541530,119640489,-158901041
10819,2017,CAN,4.68E+11,4.16E+11,-51701541259
10820,2017,CCK,9589066,3831166,-5757900
10821,2017,CHE,2.52E+11,2.74E+11,21552430865
10822,2017,CHL,62080039671,71735365656,9655325985
10823,2017,CHN,1.56E+12,2.52E+12,9.64E+11
10824,2017,CIV,10719687043,13459614954,2739927911
10825,2017,CMR,5942056933,4452898701,-1489158232
10826,2017,COD,4381126497,7290041888,2908915391
10827,2017,COG,3819672966,6645963292,2826290326
10828,2017,COK,151092004,40270330,-110821674
10829,2017,COL,44659701142,44273694649,-386006493
10830,2017,COM,367354113,81463078,-285891035
10831,2017,CPV,784205896,97611630,-686594266
10832,2017,CRI,14810158945,14270113655,-540045290
10833,2017,CUB,6489738426,1858284488,-4631453938
10834,2017,CUW,1516521399,1049238124,-467283275
10835,2017,CXR,31907655,20624826,-11282829
10836,2017,CYM,4237656779,606496085,-3631160694
10837,2017,CYP,12480000767,3864392057,-8615608710
10838,2017,CZE,1.69E+11,1.78E+11,9059159853
10839,2017,DEU,1.16E+12,1.43E+12,2.74E+11
10840,2017,DJI,4530119284,98454358,-4431664926
10841,2017,DMA,336038108,42775856,-293262252
10842,2017,DNK,93407700528,90459181255,-2948519273
10843,2017,DOM,17995386276,9178816630,-8816569646
10844,2017,DZA,45842791952,37455833886,-8386958066
10845,2017,ECU,19496685596,21943029598,2446344002
10846,2017,EGY,69905182058,28803070094,-41102111964
10847,2017,ERI,395745877,418271625,22525748
10848,2017,ESH,79560637,851260,-78709377
10849,2017,ESP,3.44E+11,3.06E+11,-38353753065
10850,2017,EST,19664594317,15468715509,-4195878808
10851,2017,ETH,9754110483,2255855149,-7498255334
10852,2017,FIN,72854836162,70123230205,-2731605957
10853,2017,FJI,2340743714,850328004,-1490415710
10854,2017,FLK,117272705,205469044,88196339
10855,2017,FRA,6.56E+11,5.41E+11,-1.16E+11
10856,2017,FRO,965877108,1482212479,516335371
10857,2017,FSM,206310578,30007026,-176303552
10858,2017,GAB,2288683122,5222292323,2933609201
10859,2017,GBR,6.20E+11,4.25E+11,-1.95E+11
10860,2017,GEO,8437506885,3007875638,-5429631247
10861,2017,GHA,15259760674,12534531945,-2725228729
10862,2017,GIB,8899004444,329288553,-8569715891
10863,2017,GIN,4132318098,5547972544,1415654446
10864,2017,GMB,1259183877,203042408,-1056141469
10865,2017,GNB,356312697,328520755,-27791942
10866,2017,GNQ,847416699,5028857695,4181440996
10867,2017,GRC,57751351082,31720123742,-26031227340
10868,2017,GRD,226085501,41701312,-184384189
10869,2017,GRL,699289865,928088765,228798900
10870,2017,GTM,17498019269,11953150504,-5544868765
10871,2017,GUM,782045538,30756500,-751289038
10872,2017,GUY,1707394653,1527362280,-180032373
10873,2017,HKG,6.11E+11,1.44E+11,-4.67E+11
10874,2017,HND,11342342438,8831302073,-2511040365
10875,2017,HRV,24873514884,15578040843,-9295474041
10876,2017,HTI,4038899477,1086355121,-2952544356
10877,2017,HUN,1.02E+11,1.16E+11,13197779912
10878,2017,IDN,1.59E+11,1.82E+11,22565289835
10879,2017,IND,4.06E+11,2.94E+11,-1.12E+11
10880,2017,IOT,68118350,16939456,-51178894
10881,2017,IRL,95287273147,1.63E+11,68019996104
10882,2017,IRN,70405235175,1.24E+11,54022919412
10883,2017,IRQ,49049701498,65149708116,16100006618
10884,2017,ISL,6576225717,4692645978,-1883579739
10885,2017,ISR,77738307708,62283954178,-15454353530
10886,2017,ITA,4.36E+11,5.03E+11,66719021714
10887,2017,JAM,5622607240,1209224646,-4413382594
10888,2017,JOR,20823056725,7737193467,-13085863258
10889,2017,JPN,6.39E+11,7.42E+11,1.03E+11
10890,2017,KAZ,36245569697,44328442174,8082872477
10891,2017,KEN,19030469657,6376653456,-12653816201
10892,2017,KGZ,8797111740,1373202911,-7423908829
10893,2017,KHM,14583393243,16515452157,1932058914
10894,2017,KIR,120131655,61969926,-58161729
10895,2017,KNA,419661903,76124435,-343537468
10896,2017,KOR,4.68E+11,6.01E+11,1.34E+11
10897,2017,KWT,35235105186,52904152580,17669047394
10898,2017,LAO,2559111169,2743091235,183980066
10899,2017,LBN,36292656169,4473174811,-31819481358
10900,2017,LBR,8397878535,1144759278,-7253119257
10901,2017,LBY,8985000593,18521704999,9536704406
10902,2017,LCA,1960097981,107200643,-1852897338
10903,2017,LKA,20700200878,11822141307,-8878059571
10904,2017,LSO,1597149691,1087461579,-509688112
10905,2017,LTU,31494938213,29697231469,-1797706744
10906,2017,LUX,23877773238,16137093402,-7740679836
10907,2017,LVA,21123633091,14132415774,-6991217317
10908,2017,MAC,10914979264,1436612978,-9478366286
10909,2017,MAR,43808704700,29127558452,-14681146248
10910,2017,MDA,4859114765,2867056140,-1992058625
10911,2017,MDG,3966057050,3511584741,-454472309
10912,2017,MDV,1794154052,321620808,-1472533244
10913,2017,MEX,4.57E+11,4.17E+11,-39483460310
10914,2017,MHL,16118502932,603385916,-15515117016
10915,2017,MKD,7116432864,6528608137,-587824727
10916,2017,MLI,4177311800,1460885347,-2716426453
10917,2017,MLT,16003238461,4181844589,-11821393872
10918,2017,MMR,21443353469,14247209985,-7196143484
10919,2017,MNE,2707705080,448485757,-2259219323
10920,2017,MNG,4230030642,5804817507,1574786865
10921,2017,MNP,151184047,3859494,-147324553
10922,2017,MOZ,8558195576,5930356414,-2627839162
10923,2017,MRT,3220594884,2361976584,-858618300
10924,2017,MSR,16548667,18609899,2061232
10925,2017,MUS,5222869746,2285378019,-2937491727
10926,2017,MWI,1613463058,1078419677,-535043381
10927,2017,MYS,2.02E+11,2.79E+11,76732925962
10928,2017,NAM,5984374978,5037539685,-946835293
10929,2017,NCL,2142873016,1588466273,-554406743
10930,2017,NER,1164383833,702986432,-461397401
10931,2017,NGA,40194344450,49930198017,9735853567
10932,2017,NIC,6777122956,5258134829,-1518988127
10933,2017,NIU,23673669,51547872,27874203
10934,2017,NLD,5.49E+11,5.18E+11,-30291521884
10935,2017,NOR,89325150399,1.11E+11,22055905144
10936,2017,NPL,8638116875,776602941,-7861513934
10937,2017,NRU,47341949,27454174,-19887775
10938,2017,NZL,40057200969,38544065027,-1513135942
10939,2017,OMN,33456524894,32860582489,-595942405
10940,2017,PAK,59527823781,23860894618,-35666929163
10941,2017,PAN,37716323882,5185499833,-32530824049
10942,2017,PCN,4520428,1590030,-2930398
10943,2017,PER,38142315578,43457082460,5314766882
10944,2017,PHL,1.21E+11,86990908952,-33893838532
10945,2017,PLW,120622822,23041504,-97581318
10946,2017,PNG,4274942033,8849790375,4574848342
10947,2017,POL,2.59E+11,2.21E+11,-37293775218
10948,2017,PRK,3434832960,1912580391,-1522252569
10949,2017,PRT,76148585753,61051536569,-15097049184
10950,2017,PRY,13239951431,8835734576,-4404216855
10951,2017,PSE,1012742767,115823030,-896919737
10952,2017,PYF,1415089658,184653823,-1230435835
10953,2017,QAT,27360921024,58489905147,31128984123
10954,2017,ROU,81711792244,71634982255,-10076809989
10955,2017,RUS,2.32E+11,3.66E+11,1.34E+11
10956,2017,RWA,1257788789,526844724,-730944065
10957,2017,SAU,1.22E+11,1.96E+11,74302587969
10958,2017,SDN,9928336058,4902462762,-5025873296
10959,2017,SEN,10066171926,3557196363,-6508975563
10960,2017,SGP,3.13E+11,3.61E+11,47774222723
10961,2017,SHN,45628747,39457176,-6171571
10962,2017,SLB,442139982,791626746,349486764
10963,2017,SLE,1221353110,871918582,-349434528
10964,2017,SLV,9124960447,6088045446,-3036915001
10965,2017,SMR,303703169,257371569,-46331600
10966,2017,SOM,3070130630,324836070,-2745294560
10967,2017,SPM,58280174,5198450,-53081724
10968,2017,SRB,22683415995,17937102878,-4746313117
10969,2017,SSD,563508130,1279044493,715536363
10970,2017,STP,137580339,13606354,-123973985
10971,2017,SUR,1354446044,1430643760,76197716
10972,2017,SVK,82454785252,84391351028,1936565776
10973,2017,SVN,36891319807,32463273553,-4428046254
10974,2017,SWE,1.51E+11,1.51E+11,-418331234
10975,2017,SWZ,1561071866,1975147290,414075424
10976,2017,SXM,687617696,127782080,-559835616
10977,2017,SYC,912288984,591990904,-320298080
10978,2017,SYR,6095884369,554034201,-5541850168
10979,2017,TCA,412603073,19510849,-393092224
10980,2017,TCD,585566213,1241221652,655655439
10981,2017,TGO,9689089647,2376242294,-7312847353
10982,2017,THA,1.81E+11,2.37E+11,55741352705
10983,2017,TJK,3322889018,887865131,-2435023887
10984,2017,TKL,48303697,65695107,17391410
10985,2017,TKM,4350940417,7465558299,3114617882
10986,2017,TLS,606667463,93546526,-513120937
10987,2017,TON,134207173,16449454,-117757719
10988,2017,TTO,5554508770,9154621631,3600112861
10989,2017,TUN,21198454308,15061900221,-6136554087
10990,2017,TUR,2.18E+11,1.55E+11,-62659150802
10991,2017,TUV,84696946,4178086,-80518860
10992,2017,TWN,3.36E+11,4.08E+11,72136189039
10993,2017,TZA,10730237636,5285650507,-5444587129
10994,2017,UGA,5233452219,2909608963,-2323843256
10995,2017,UKR,52484398526,46932291978,-5552106548
10996,2017,URY,11386717430,9992274724,-1394442706
10997,2017,USA,2.29E+12,1.54E+12,-7.49E+11
10998,2017,UZB,11982269464,6506543242,-5475726222
10999,2017,VAT,62059948,5215632,-56844316
11000,2017,VCT,328397694,242815640,-85582054
11001,2017,VEN,10042426371,30376798870,20334372499
11002,2017,VGB,1100335115,392891077,-707444038
11003,2017,VNM,2.40E+11,2.56E+11,16107754630
11004,2017,VUT,334521444,212409393,-122112051
11005,2017,WLF,36439541,905640,-35533901
11006,2017,WSM,377937067,37025148,-340911919
11007,2017,YEM,6634094444,1761459809,-4872634635
11008,2017,ZAF,82893047693,1.02E+11,19250070551
11009,2017,ZMB,8114339020,6748061058,-1366277962
11010,2017,ZWE,3588504790,2335290344,-1253214446